"aa" = (/turf/UndergroundLab/Tile10,/area)
"ab" = (/turf/UndergroundLab/Tile11,/area)
"ac" = (/turf/UndergroundLab/Tile23,/area)
"ad" = (/turf/UndergroundLab/Tile3,/area)
"ae" = (/turf/UndergroundLab/Tile4,/area)
"af" = (/turf/UndergroundLab/Tile21,/area)
"ag" = (/turf/UndergroundLab/Tile22,/area)
"ah" = (/turf/UndergroundLab/Tile20,/area)
"ai" = (/turf/UndergroundLab/Background/one0,/area)
"aj" = (/turf/UndergroundLab/Background/two0,/area)
"ak" = (/turf/UndergroundLab/Background/zero0,/area)
"al" = (/turf/UndergroundLab/Background/one2,/area)
"am" = (/turf/UndergroundLab/Background/two2,/turf/Dense,/area)
"an" = (/turf/UndergroundLab/Background/zero2,/turf/Dense,/area)
"ao" = (/turf/UndergroundLab/Background/one2,/turf/Dense,/area)
"ap" = (/turf/UndergroundLab/Background/two2,/area)
"aq" = (/turf/UndergroundLab/Background/zero2,/area)
"ar" = (/turf/UndergroundLab/Background/one1,/area)
"as" = (/turf/UndergroundLab/Background/two1,/area)
"at" = (/turf/UndergroundLab/Background/zero1,/area)
"au" = (/turf/UndergroundLab/Background/zero0,/turf/Dense,/area)
"av" = (/turf/UndergroundLab/Background/one2,/turf/UndergroundLab/Tile15,/area)
"aw" = (/turf/UndergroundLab/Tile13,/turf/Capsules/Capsule,/turf/Dense,/turf/Capsules/Capsule,/area)
"ax" = (/turf/UndergroundLab/Tile13,/turf/Dense,/area)
"ay" = (/turf/UndergroundLab/Tile13,/area)
"az" = (/turf/UndergroundLab/Background/zero2,/turf/UndergroundLab/Tile16,/area)
"aA" = (/turf/UndergroundLab/Background/one1,/turf/UndergroundLab/Tile17,/area)
"aB" = (/turf/UndergroundLab/Background/two1,/turf/UndergroundLab/Tile18,/area)
"aC" = (/turf/UndergroundLab/Background/zero1,/turf/UndergroundLab/Tile18,/area)
"aD" = (/turf/UndergroundLab/Background/one1,/turf/UndergroundLab/Tile18,/area)
"aE" = (/turf/UndergroundLab/Background/zero1,/turf/UndergroundLab/Tile19,/area)
"aF" = (/turf/TwinTowers/t20,/area)
"aG" = (/turf/TwinTowers/ttceiling/zero1,/area)
"aH" = (/turf/TwinTowers/ttceiling/one1,/area)
"aI" = (/turf/TwinTowers/ttceiling/two1,/area)
"aJ" = (/turf/TwinTowers/ttceiling/three1,/area)
"aK" = (/turf/TwinTowers/ttceiling/four1,/area)
"aL" = (/turf/TwinTowers/ttceiling/zero0,/area)
"aM" = (/turf/TwinTowers/ttceiling/one0,/area)
"aN" = (/turf/TwinTowers/ttceiling/two0,/area)
"aO" = (/turf/TwinTowers/ttceiling/three0,/area)
"aP" = (/turf/TwinTowers/ttceiling/four0,/area)
"aQ" = (/turf/UndergroundLab/Background/zero0,/turf/TwinTowers/t19,/area)
"aR" = (/turf/UndergroundLab/Background/one0,/turf/TwinTowers/t19,/area)
"aS" = (/obj/Switches/Door{DoorNumber = 2},/turf/UndergroundLab/Background/zero2,/area)
"aT" = (/obj/Switches/Door{DoorNumber = 2},/turf/UndergroundLab/Background/one2,/area)
"aU" = (/turf/UndergroundLab/Tile2,/area)
"aV" = (/turf/UndergroundLab/Tile1,/area)
"aW" = (/turf/UndergroundLab/Background/zero2,/turf/UndergroundLab/Tile17,/area)
"aX" = (/turf/UndergroundLab/Background/one2,/turf/UndergroundLab/Tile18,/area)
"aY" = (/turf/UndergroundLab/Background/two2,/turf/UndergroundLab/Tile18,/area)
"aZ" = (/turf/UndergroundLab/Background/zero2,/turf/UndergroundLab/Tile18,/area)
"ba" = (/turf/UndergroundLab/Background/one2,/turf/UndergroundLab/Tile19,/area)
"bb" = (/turf/UndergroundLab/Background/zero1,/turf/Dense,/area)
"bc" = (/turf/UndergroundLab/Background/one1,/turf/Dense,/area)
"bd" = (/turf/UndergroundLab/Background/two1,/turf/Dense,/area)
"be" = (/turf/UndergroundLab/Tile1,/turf/Capsules/Capsule,/turf/Dense,/turf/Capsules/Capsule,/area)
"bf" = (/turf/UndergroundLab/Tile2,/turf/Dense,/area)
"bg" = (/turf/UndergroundLab/Tile1,/turf/Dense,/area)
"bh" = (/turf/UndergroundLab/Background/one2,/turf/UndergroundLab/Tile19,/turf/UndergroundLab/Tile18,/area)
"bi" = (/turf/UndergroundLab/Background/zero2,/turf/UndergroundLab/Tile19,/area)
"bj" = (/turf/UndergroundLab/Background/two2,/turf/UndergroundLab/Tile17,/area)
"bk" = (/turf/UndergroundLab/Background/zero1,/turf/UndergroundLab/Tile24,/area)
"bl" = (/turf/UndergroundLab/Background/zero1,/turf/UndergroundLab/Tile25,/area)
"bm" = (/turf/UndergroundLab/Background/zero0,/turf/UndergroundLab/Tile24,/area)
"bn" = (/turf/UndergroundLab/Background/zero0,/turf/UndergroundLab/Tile25,/area)
"bo" = (/turf/UndergroundLab/Background/zero2,/turf/UndergroundLab/Tile24,/area)
"bp" = (/turf/UndergroundLab/Background/zero2,/turf/UndergroundLab/Tile25,/area)
"bq" = (/turf/UndergroundLab/Background/one2,/turf/UndergroundLab/Tile17,/area)
"br" = (/turf/UndergroundLab/Background/zero0,/turf/UndergroundLab/Tile17,/area)
"bs" = (/turf/UndergroundLab/Background/one0,/turf/UndergroundLab/Tile19,/area)
"bt" = (/turf/UndergroundLab/Background/zero1,/turf/UndergroundLab/Tile15,/area)
"bu" = (/turf/UndergroundLab/Background/one1,/turf/UndergroundLab/Tile16,/area)
"bv" = (/turf/UndergroundLab/Background/one1,/turf/UndergroundLab/Tile15,/area)
"bw" = (/turf/UndergroundLab/Background/two1,/turf/UndergroundLab/Tile16,/area)
"bx" = (/turf/UndergroundLab/Tile8,/area)
"by" = (/turf/UndergroundLab/Tile9,/area)
"bz" = (/turf/Junkyard/Tile1a,/area)
"bA" = (/turf/UndergroundLab/Background/one0,/turf/UndergroundLab/Tile17,/area)
"bB" = (/turf/UndergroundLab/Background/two0,/turf/UndergroundLab/Tile19,/area)
"bC" = (/turf/UndergroundLab/Tile3,/turf/Junkyard/Tile2,/area)
"bD" = (/turf/UndergroundLab/Tile4,/turf/Junkyard/Tile2,/area)
"bE" = (/turf/UndergroundLab/Background/two2,/turf/UndergroundLab/Tile25,/area)
"bF" = (/turf/UndergroundLab/Background/two1,/turf/UndergroundLab/Tile15,/area)
"bG" = (/turf/UndergroundLab/Background/zero1,/turf/UndergroundLab/Tile16,/area)
"bH" = (/turf/UndergroundLab/Background/two1,/turf/UndergroundLab/Tile25,/area)
"bI" = (/turf/UndergroundLab/Background/two0,/turf/UndergroundLab/Tile17,/area)
"bJ" = (/turf/UndergroundLab/Background/zero0,/turf/UndergroundLab/Tile19,/area)
"bK" = (/turf/UndergroundLab/Background/two0,/turf/UndergroundLab/Tile25,/area)
"bL" = (/turf/UndergroundLab/Background/two2,/turf/UndergroundLab/Tile19,/area)
"bM" = (/turf/UndergroundLab/Background/two0,/turf/UndergroundLab/Tile15,/area)
"bN" = (/turf/UndergroundLab/Background/zero0,/turf/UndergroundLab/Tile16,/area)
"bO" = (/turf/UndergroundLab/Background/one0,/turf/Dense,/area)
"bP" = (/turf/UndergroundLab/Background/two0,/turf/Dense,/area)
"bQ" = (/turf/UndergroundLab/Background/two0,/turf/UndergroundLab/Tile16,/turf/Dense,/area)
"bR" = (/turf/UndergroundLab/Background/two2,/turf/UndergroundLab/Tile15,/area)
"bS" = (/turf/UndergroundLab/Background/two1,/turf/UndergroundLab/Tile17,/area)
"bT" = (/turf/UndergroundLab/Background/zero2,/turf/UndergroundLab/Tile15,/area)
"bU" = (/turf/UndergroundLab/Background/two2,/turf/UndergroundLab/Tile16,/area)
"bV" = (/turf/Junkyard/Tile1,/area)
"bW" = (/turf/UndergroundLab/Background/zero1,/turf/UndergroundLab/Tile17,/area)
"bX" = (/turf/UndergroundLab/Background/one1,/turf/UndergroundLab/Tile14,/area)
"bY" = (/turf/UndergroundLab/Background/two1,/turf/UndergroundLab/Tile14,/area)
"bZ" = (/turf/UndergroundLab/Background/zero1,/turf/UndergroundLab/Tile14,/area)
"ca" = (/turf/UndergroundLab/Background/two1,/turf/UndergroundLab/Tile19,/area)
"cb" = (/turf/UndergroundLab/Background/one2,/turf/UndergroundLab/Tile16,/area)
"cc" = (/turf/UndergroundLab/Background/one1,/turf/UndergroundLab/Tile19,/area)
"cd" = (/turf/UndergroundLab/Background/two0,/turf/UndergroundLab/Tile18,/area)
"ce" = (/turf/UndergroundLab/Background/zero0,/turf/UndergroundLab/Tile18,/area)
"cf" = (/turf/UndergroundLab/Background/one0,/turf/UndergroundLab/Tile18,/area)
"cg" = (/turf/UndergroundLab/Tile2,/turf/Capsules/Capsule,/turf/Dense,/turf/Capsules/Capsule,/area)
"ch" = (/turf/UndergroundLab/Background/zero0,/turf/UndergroundLab/Tile15,/area)
"ci" = (/turf/UndergroundLab/Background/one0,/turf/UndergroundLab/Tile16,/area)
"cj" = (/turf/UndergroundLab/Background/one0,/turf/UndergroundLab/Tile15,/area)
"ck" = (/turf/UndergroundLab/Background/two0,/turf/UndergroundLab/Tile16,/area)
"cl" = (/turf/UndergroundLab/Tile5,/area)
"cm" = (/turf/UndergroundLab/Tile7,/area)
"cn" = (/turf/UndergroundLab/Tile6,/area)

(1,1,1) = {"
aaabacadaeadaeadaeadaeadaeadaeadaeadaeadaeadaeadaeadaeadaeadaeadaeadaeadaeadaeadaeadaeadaeadaeadaeadaeadaeadaeadaeadaeadaeadaeadaeadaeadaeadaeadaeadaeadaeadaeadaeadaeadaeadaeadaeadaeadaeadaeadaeafabaa
abaaagadaeadaeadaeadaeadaeadaeadaeadaeadaeadaeadaeadaeadaeadaeadaeadaeadaeadaeadaeadaeadaeadaeadaeadaeadaeadaeadaeadaeadaeadaeadaeadaeadaeadaeadaeadaeadaeadaeadaeadaeadaeadaeadaeadaeadaeadaeadaeahaaab
abaaacadaeadaeadaeadaeadaeadaeadaeadaeadaeadaeadaeadaeadaeadaeadaeadaeadaeadaeadaeadaeadaeadaeadaeadaeadaeadaeadaeadaeadaeadaeadaeadaeadaeadaeadaeadaeadaeadaeadaeadaeadaeadaeadaeadaeadaeadaeadaeafabaa
aaabagadaeadaeadaeadaeadaeadaeadaeadaeadaeadaeadaeadaeadaeadaeadaeadaeadaeadaeadaeadaeadaeadaeadaeadaeadaeadaeadaeadaeadaeadaeadaeadaeadaeadaeadaeadaeadaeadaeadaeadaeadaeadaeadaeadaeadaeadaeadaeahaaab
abaaacadaeadaeadaeadaeadaeadaeadaeadaeadaeadaeadaeadaeadaeadaeadaeadaeadaeadaeadaeadaeadaeadaeadaeadaeadaeadaeadaeadaeadaeadaeadaeadaeadaeadaeadaeadaeadaeadaeadaeadaeadaeadaeadaeadaeadaeadaeadaeafabaa
aaabagadaeadaeadaeadaeadaeadaeadaeadaeadaeadaeadaeadaeadaeadaeadaeadaeadaeadaeadaeadaeadaeadaeadaeadaeadaeadaeadaeadaeadaeadaeadaeadaeadaeadaeadaeadaeadaeadaeadaeadaeadaeadaeadaeadaeadaeadaeadaeahaaab
abaaacadaeadaeadaeadaeadaeadaeadaeadaeadaeadaeadaeadaeadaeadaeadaeadaeadaeadaeadaeadaeadaeadaeadaeadaeadaeadaeadaeadaeadaeadaeadaeadaeadaeadaeadaeadaeadaeadaeadaeadaeadaeadaeadaeadaeadaeadaeadaeafabaa
aaabagadaeadaeadaeadaeadaeadaeadaeadaeadaeadaeadaeadaeadaeadaeadaeadaeadaeadaeadaeadaeadaeadaeadaeadaeadaeadaeadaeadaeadaeadaeadaeadaeadaeadaeadaeadaeadaeadaeadaeadaeadaeadaeadaeadaeadaeadaeadaeahaaab
abaaacadaeadaeadaeadaeadaeadaeadaeadaeadaeadaeadaeadaeadaeadaeadaeadaeadaeadaeadaeadaeadaeadaeadaeadaeadaeadaeadaeadaeadaeadaeadaeadaeadaeadaeadaeadaeadaeadaeadaeadaeadaeadaeadaeadaeadaeadaeadaeafabaa
aaabagadaeadaeadaeadaeadaeadaeadaeadaeadaeadaeadaeadaeadaeadaeadaeadaeadaeadaeadaeadaeadaeadaeadaeadaeadaeadaeadaeadaeadaeadaeadaeadaeadaeadaeadaeadaeadaeadaeadaeadaeadaeadaeadaeadaeadaeadaeadaeahaaab
abaaacadaeadaeadaeadaeadaeadaeadaeadaeadaeadaeadaeadaeadaeadaeadaeadaeadaeadaeadaeadaeadaeadaeadaeadaeadaeadaeadaeadaeadaeadaeadaeadaeadaeadaeadaeadaeadaeadaeadaeadaeadaeadaeadaeadaeadaeadaeadaeafabaa
aaabagadaeadaeadaeadaeadaeadaeadaeadaeadaeadaeadaeadaeadaeadaeadaeadaeadaeadaeadaeadaeadaeadaeadaeadaeadaeadaeadaeadaeadaeadaeadaeadaeadaeadaeadaeadaeadaeadaeadaeadaeadaeadaeadaeadaeadaeadaeadaeahaaab
abaaacadaeadaeadaeadaeadaeadaeadaeadaeadaeadaeadaeadaeadaeadaeadaeadaeadaeadaeadaeadaeadaeadaeadaeadaeadaeadaeadaeadaeadaeadaeadaeadaeadaeadaeadaeadaeadaeadaeadaeadaeadaeadaeadaeadaeadaeadaeadaeafabaa
aaabagadaeadaeadaeadaeadaeadaeadaeadaeadaeadaeadaeadaeadaeadaeadaeadaeadaeadaeadaeadaeadaeadaeadaeadaeadaeadaeadaeadaeadaeadaeadaeadaeadaeadaeadaeadaeadaeadaeadaeadaeadaeadaeadaeadaeadaeadaeadaeahaaab
abaaacadaeadaeadaeadaeadaeadaeadaeadaeadaeadaeadaeadaeadaeadaeadaeadaeadaeadaeadaeadaeadaeadaeadaeadaeadaeadaeadaeadaeadaeadaeadaeadaeadaeadaeadaeadaeadaeadaeadaeadaeadaeadaeadaeadaeadaeadaeadaeafabaa
aaabagadaeadaeadaeadaeadaeadaeadaeadaeadaeadaeadaeadaeadaeadaeadaeadaeadaeadaeadaeadaeaiajakaiajakaiajakaiajakadaeadaeadaeadaeadaeadaeadaeadaeadaeadaeadaeadaeadaeadaeadaeadaeadaeadaeadaeadaeadaeahaaab
abaaacadaeadaeadaeadaeadaeadaeadaeadaeadaeadaeadaeadaeadaeadaeadaeadaeadaeadaeadaeadaealamanaoapaqalapaqalapaqadaeadaeadaeadaeadaeadaeadaeadaeadaeadaeadaeadaeadaeadaeadaeadaeadaeadaeadaeadaeadaeafabaa
aaabagadaeadaeadaeadaeadaeadaeadaeadaeadaeadaeadaeadaeadaeadaeadaeadaeadaeadaeadaeadaearasatarasatarasatarasatadaeadaeadaeadaeadaeadaeadaeadaeadaeadaeadaeadaeadaeadaeadaeadaeadaeadaeadaeadaeadaeahaaab
abaaacadaeadaeadaeadaeadaeadaeadaeadaeadaeadaeadaeadaeadaeadaeadaeadaeadaeadaeadaeadaeaiajauaiajakaiajakaiajakadaeadaeadaeadaeadaeadaeadaeadaeadaeadaeadaeadaeadaeadaeadaeadaeadaeadaeadaeadaeadaeafabaa
aaabagadaeadaeadaeadaeadaeadaeadaeadaeadaeadaeadaeadaeadaeadaeadaeadaeadaeadaeadaeadaeavawaxaxayayayayayayayazadaeadaeadaeadaeadaeadaeadaeadaeadaeadaeadaeadaeadaeadaeadaeadaeadaeadaeadaeadaeadaeahaaab
abaaacadaeadaeadaeadaeadaeadaeadaeadaeadaeadaeadaeadaeadaeadaeadaeadaeadaeadaeadaeadaeaAaBaCaDaBaCaDaBaCaDaBaEadaeadaeadaeadaeadaeadaeadaeadaeadaeadaeadaeadaeadaeadaeadaeadaeadaeadaeadaeadaeadaeafabaa
aaabagadaeadaeadaeadaeadaeadaeadaeadaeadaeadaeadaeadaeadaeadaeadaeadaeadaeadaeadaeadaeaiajakaiajakaiajakaiajakadaeadaeadaeadaeadaeadaeadaeadaeadaeadaeadaeadaeadaeadaeadaeadaeadaeadaeadaeadaeadaeahaaab
abaaacadaeadaeadaeadaeadaeadaeadaeadaeadaeadaeadaeadaeadaeadaeadaeadaeadaeaFaGaHaIaJaKalapaqalapaqalapaqalapaqaGaHaIaJaKaFadaeadaeadaeadaeadaeadaeadaeadaeadaeadaeadaeadaeadaeadaeadaeadaeadaeadaeafabaa
aaabagadaeadaeadaeadaeadaeadaeadaeadaeadaeadaeadaeadaeadaeadaeadaeadaeadaeaFaLaMaNaOaParasatarasatarasatarasataLaMaNaOaPaFadaeadaeadaeadaeadaeadaeadaeadaeadaeadaeadaeadaeadaeadaeadaeadaeadaeadaeahaaab
abaaacadaeadaeadaeadaeadaeadaeadaeadaeadaeadaeadaeadaeadaeadaeadaeadaeadaeaFajakaiajaQaiajakaiajakaiajakaiajakaRajakaiajaFadaeadaeadaeadaeadaeadaeadaeadaeadaeadaeadaeadaeadaeadaeadaeadaeadaeadaeafabaa
aaabagadaeadaeadaeadaeadaeadaeadaeadaeadaeadaeadaeadaeadaeadaeadaeadaeadaeaFapaqalapaSalapaqalapaqalapaqalapaqaTapaqalapaFadaeadaeadaeadaeadaeadaeadaeadaeadaeadaeadaeadaeadaeadaeadaeadaeadaeadaeahaaab
abaaacadaeadaeadaeadaeadaeadaeadaeadaeadaeadaeadaeadaeadaeadaeadaeadaeadaeaFaUaVaUaVaUaVaUaVaUaVaUaVaUaVaUaVaUaVaUaVaUaVaFadaeadaeadaeadaeadaeadaeadaeadaeadaeadaeadaeadaeadaeadaeadaeadaeadaeadaeafabaa
aaabagadaeadaeadaeadaeadaeadaeadaeadaeadaeadaeadaeadaeadaeadaeadaeadaeadaeadaeadaeadaeadaeadaeadaeadaeadaeadaeadaeadaeadaeadaeadaeadaeadaeadaeadaeadaeadaeadaeadaeadaeadaeadaeadaeadaeadaeadaeadaeahaaab
abaaacadaeadaeadaeadaeadaeadaeadaeadaeadaeadaeadaeadaeadaeadaeadaeadaeadaeadaeadaeadaeadaeadaeadaeadaeadaeadaeadaeadaeadaeadaeadaeadaeadaeadaeadaeadaeadaeadaeadaeadaeadaeadaeadaeadaeadaeadaeadaeafabaa
aaabagadaeadaeadaeadaeadaeadaeadaeadaeadaeadaeadaeadaeadaeadaeadaeadaeadaeadaeadaeadaeadaeadaeadaeadaeadaeadaeadaeadaeadaeadaeadaeadaeadaeadaeadaeadaeadaeadaeadaeadaeadaeadaeadaeadaeadaeadaeadaeahaaab
abaaacadaeadaeadaeadaeadaeadaeadaeadaeadaeadaeadaeadaeadaeadaeadaeadaeadaeadaeadaeadaeadaeadaeadaeadaeadaeadaeadaeadaeadaeadaeadaeadaeadaeadaeadaeadaeadaeadaeadaeadaeadaeadaeadaeadaeadaeadaeadaeafabaa
aaabagadaeadaeadaeadaeadaeadaeadaeadaeadaeadaeadaeadaeadaeadaeadaeadaeadaeadaeadaeadaeadaeadaeadaeadaeadaeadaeadaeadaeadaeadaeadaeadaeadaeadaeadaeadaeadaeadaeadaeadaeadaeadaeadaeadaeadaeadaeadaeahaaab
abaaacadaeadaeadaeadaeadaeadaeadaeadaeadaeadaeadaeadaeadaeadaeadaeadaeadaeadaeadaeadaeadaeadaeadaeadaeadaeadaeadaeadaeadaeadaeadaeadaeadaeadaeadaeadaeadaeadaeadaeadaeadaeadaeadaeadaeadaeadaeadaeafabaa
aaabagadaeadaeadaeadaeadaeadaeadaeadaeadaeadaeadaeadaeadaeadaeadaeadaeadaeadaeadaeadaeadaeadaeadaeadaeadaeadaeadaeadaeadaeadaeadaeadaeadaeadaeadaeadaeadaeadaeadaeadaeadaeadaeadaeadaeadaeadaeadaeahaaab
abaaacadaeadaeadaeadaeadaeadaeadaeadaeadaeadaeadaeadaeadaeadaeadaeadaeadaeadaeadaeadaeadaeadaeadaeadaeadaeadaeadaeadaeadaeadaeadaeadaeadaeadaeadaeadaeadaeadaeadaeadaeadaeadaeadaeadaeadaeadaeadaeafabaa
aaabagadaeadaeadaeadaeadaeadaeadaeadaeadaeadaeadaeadaeadaeadaeadaeadaeadaeadaeadaeadaeadaeadaeadaeadaeadaeadaeadaeadaeadaeadaeadaeadaeadaeadaeadaeadaeadaeadaeadaeadaeadaeadaeadaeadaeadaeadaeadaeahaaab
abaaacadaeadaeadaeadaeadaeadaeadaeadaeadaeadaeadaeadaeadaeadaeadaeadaeadaeadaeadaeadaeadaeadaeadaeadaeadaeadaeadaeadaeadaeadaeadaeadaeadaeadaeadaeadaeadaeadaeadaeadaeadaeadaeadaeadaeadaeadaeadaeafabaa
aaabagadaeadaeadaeadaeadaeadaeadaeadaeadaeadaeadaeadaeadaeadaeadaeadaeadaeadaeadaeadaeadaeadaeadaeadaeadaeadaeadaeadaeadaeadaeadaeadaeadaeadaeadaeadaeadaeadaeadaeadaeadaeadaeaWaXaYaZaXaYaZbaadaeahaaab
abaaacadaeadaeadaeadaeadaeadaeadaeadaeadaeadaeadaeadaeadaeadaeadaeadaeadaeadaeadaeadaeadaeadaeadaeadaeadaeadaeadaeadaeadaeadaeadaeadaeadaeadaeadaeadaeadaeadaeadaeadaeadaeadaebbbcbdatarasataradaeafabaa
aaabagadaeadaeadaeadaeadaeadaeadaeadaeadaeadaeadaeadaeadaeadaeadaeadaeadaeadaeadaeadaeadaeadaeadaeadaeadaeadaeadaeadaeadaeadaeadaeadaeadaeadaeadaeadaeadaeadaeadaeadaeadaeadaeakaiajakaiajakaiadaeahaaab
abaaacadaeadaeadaeadaeadaeadaeadaeadaeadaeadaeadaeadaeadaeadaeadaeadaeadaeadaeadaeadaeadaeadaeadaeadaeadaeadaeadaeadaeadaeadaeadaeadaeadaeadaeadaeadaeadaeadaeadaeadaeadaeadaeaqaoapaqalapaqaladaeafabaa
aaabagadaeadaeadaeadaeadaeadaeadaeadaeadaeadaeadaeadaeadaeadaeadaeadaeadaeadaeadaeadaeadaeadaeadaeadaeadaeadaeadaeadaeadaeadaeadaeadaeadaeadaeadaeadaeadaeadaeadaeadaeadaeadaebebfbgaUarasataradaeahaaab
abaaacadaeadaeadaeadaeadaeadaeadaeadaeadaeadaeadaeadaeadaeadaeadaeadaeadaeadaeadaeadaeadaeadaeadaeadaeadaeadaeadaeadaeadaeadaeadaeadaeadaeadaeadaeadaeadaeadaeadaeadaeadaeadaeadaeadaeaiajakaiadaeafabaa
aaabagadaeadaeadaeadaeadaeadaeadaeadaeadaeadaeadaeadaeadaeadaeadaeadaeadaeadaeaWaXaYaZaXaYaZaXaYaZaXaYaZaXaYaZaXaYaZaXaYaZaXaYaZaXaYaZaXaYaZaXaYaZaXaYaZaXaYaZaXaYaZaXaYaZaXaYaZbhaYbialapaqalbjbiahaaab
abaaacadaeadaeadaeadaeadaeadaeadaeadaeadaeadaeadaeadaeadaeadaeadaeadaeadaeadaebkarasatarasatarasatarasatarasatarasatarasatarasatarasatarasatarasatarasatarasatarasatarasatarasatarasatarasatarasblafabaa
aaabagadaeadaeadaeadaeadaeadaeadaeadaeadaeadaeadaeadaeadaeadaeadaeadaeadaeadaebmaiajakaiajakaiajakaiajakaiajakaiajakaiajakaiajakaiajakaiajakaiajakaiajakaiajakaiajakaiajakaiajakaiajakaiajakaiajbnahaaab
abaaacadaeadaeadaeadaeadaeadaeadaeadaeadaeadaeadaeadaeadaeadaeadaeadaeadaeadaeboalapaqalapaqalapaqalapaqalapaqalapaqalapaqalapaqalapaqalapaqalapaqalapaqalapaqalapaqalapaqalapaqalapaqalapaqalapbpafabaa
aaabagadaeadaeadaeadaeadaeadaeadaeadaeadaeadaeadaeadaeadaeadaeadaeadaeadaeadaebkarasatarasatarasatarasatarasatarasatarasatarasatarasatarasatarasatarasatarasatarasatarasatarasatarasatarasatarasblahaaab
abaaacadaeadaeadaeadaeadaeadaeadaeadaeadaeadaeadaeadaeadaeadaeadaeadaeadaeadaebmaiajakaiajakaiajakaiajakaiajakaiajakaiajakaiajakaiajakaiajakaiajakaiajakaiajakaiajakaiajakaiajakaiajakaiajakaiajbnafabaa
aaabagadaeadaeadaeadaeadaeadaeadaeadaeadaeadaeadaeadaeadaeadaeadaeadaeadaeadaeboalapaqalapaqalapaqalapaqalapaqalapaqalapaqalapaqalapaqalapaqalapaqalapaqalapaqalapaqalapaqalapaqalapaqalapaqalapbpahaaab
abaaacadaeadaeadaeadaeadaeadaeadaeadaeadaeadaeadaeadaeadaeadaeadaeadaeadaeadaebkarasatarasatarasatarasatarasataVaUaVaUasataVaUaVaUasataVaUaVaUasataVaUaVaUasataVaUaVaUasataVaUaVaUasataVaUaVaUasblafabaa
aaabagadaeadaeadaeadaeadaeadaeadaeadaeadaeadaeadaeadaeadaeadaeadaeadaeadaeadaebmaiajakaiajakaiajakaiajakaiajakadaeadaeajakadaeadaeajakadaeadaeajakadaeadaeajakadaeadaeajakadaeadaeajakadaeadaeajbnahaaab
abaaacadaeadaeadaeadaeadaeadaeadaeadaeadaeadaeadaeadaeadaeadaeadaeadaeadaeadaeboalapaqalapaqalapaqalapaVaUapaqbqaYaZbaapaqbqaYaZbaapaqbqaYaZbaapaqbqaYaZbaapaqbqaYaZbaapaqbqaYaZbaapaqbqaYaZbaapbpafabaa
aaabagadaeadaeadaeadaeadaeadaeadaeadaeadaeadaeadaeadaeadaeadaeadaeadaeadaeadaebkarasatarasatarasatarasadaeasatarasatarasatarasatarasatarasatarasatarasatarasatarasatarasatarasatarasatarasatarasblahaaab
abaaacadaeadaeadaeadaeadaeadaeadaeadaeadaeadaeadaeadaeadaeadaeadaeadaeadaeadaebmaiajakaiajakaiajakaiajbrbsajakaiajakaiajakaiajakaiajakaiajakaiajakaiajakaiajakaiajakaiajakaiajakaiajakaiajakaiajbnafabaa
aaabagadaeadaeadaeadaeadaeadaeadaeadaeadaeadaeadaeadaeadaeadaeadaeadaeadaeadaeboalapaqalapaqalapaqalapaqalapaqalapaqalapaqalapaqalapaqalapaqalapaqalapaqalapaqalapaqalapaqalapaqalapaqalapaqalapbpahaaab
abaaacadaeadaeadaeadaeadaeadaeadaeadaeadaeadaeadaeadaeadaeadaeadaeadaeadaeadaebtbuasatarasatarasatbvbwbxbybzbzbzbzbzbzbzbzbzbzbzbzbzbzbzbzbzbzbzbzbzbzbzbzbzbzbzbzbzbzbzbzbzbzbzbzbzbzbzbzbzbzbzbzafabaa
aaabagadaeadaeadaeadaeadaeadaeadaeadaeadaeadaeadaeadaeadaeadaeadaeadaeadaeadaebrbsajakaiajakaiajakbAbBadaebCbDbCbDbCbDbCbDbCbDbCbDbCbDbCbDbCbDbCbDbCbDbCbDbCbDbCbDbCbDbCbDbCbDbCbDbCbDbCbDbCbDbCbDahaaab
abaaacadaeadaeadaeadaeadaeadaeadaeadaeadaeadaeadaeadaeadaeadaeadaeadaeadaeadaeboalapaqalapaqalapaqalbEadaeadaeadaeadaeadaeadaeadaeadaeadaeadaeadaeadaeadaeadaeadaeadaeadaeadaeadaeadaeadaeadaeadaeafabaa
aaabagadaeadaeadaeadaeadaeadaeadaeadaeadaeadaeadaeadaeadaeadaeadaeadaeadaeadaebkarasatarbFbGarasatarbHadaeadaeadaeadaeadaeadaeadaeadaeadaeadaeadaeadaeadaeadaeadaeadaeadaeadaeadaeadaeadaeadaeadaeahaaab
abaaacadaeadaeadaeadaeadaeadaeadaeadaeadaeadaeadaeadaeadaeadaeadaeadaeadaeadaebmaiajakaibIbJaiajakaibKadaeadaeadaeadaeadaeadaeadaeadaeadaeadaeadaeadaeadaeadaeadaeadaeadaeadaeadaeadaeadaeadaeadaeafabaa
aaabagadaeadaeadaeadaeadaeadaeadaeadaeadaeadaeadaeadaeadaeadaeadaeadaeadaeadaeboalapaqalapaqalapaqalbEadaeadaeadaeadaeadaeadaeadaeadaeadaeadaeadaeadaeadaeadaebqaYaZaXaYaZaXbLadaeadaeadaeadaeadaeahaaab
abaaacadaeadaeadaeadaeadaeadaeadaeadaeadaeadaeadaeadaeadaeadaeadaeadaeadaeadaebkarasatarasatarasatarbHadaeadaeadaeadaeadaeadaeadaeadaeadaeadaeadaeadaeadaeadaearasatarasatarasadaeadaeadaeadaeadaeafabaa
aaabagadaeadaeadaeadaeadaeadaeadaeadaeadaeadaeadaeadaeadaeadaeadaeadaeadaeadaebmaibMbNaiajakaibMbNaibKadaeadaeadaeadaeadaeadaeadaeadaeadaeadaeadaeadaeadaeadaeaiajakaiajaubObPadaeadaeadaeadaeadaeahaaab
abaaacadaeadaeadaeadaeadaeadaeadaeadaeadaeadaeadaeadaeadaeadaeadaeadaeadaeadaeboalbjbialapaqalbjbialbEadaeadaeadaeadaeadaeadaeadaeadaeadaeadaeadaeadaeadaeadaealapaqalapaqalapadaeadaeadaeadaeadaeafabaa
aaabagadaeadaeadaeadaeadaeadaeadaeadaeadaeadaeadaeadaeadaeadaeadaeadaeadaeadaebkarasatarasatarasatarbHadaeadaeadaeadaeadaeadaeadaeadaeadaeadaeadaeadaeadaeadaearasatarasatbcasadaeadaeadaeadaeadaeahaaab
abaaacadaeadaeadaeadaeadaeadaeadaeadaeadaeadaeadaeadaeadaeadaeadaeadaeadaeadaebmaiajakaiajakaiajakaibKadaeadaeadaeadaeadaeadaeadaeadaeadaeadaeadaeadaeadaeadaeaiajakaibMawaxbQadaeadaeadaeadaeadaeafabaa
aaabaganaoamaWaXaYaZaXaYaZaXaYaZaXaYaZaXaYaZaXaYaZaXaYaZaXaYaZaXaYaZaXaYaZaXbLaqalapaqalbRazalapaqalapaWaXaYaZaXaYaZaXaYaZaXaYaZaXaYaZaXaYaZaXaYaZaXaYaZaXaYbialapaqalbjaZaXbLadaeadaeadaeadaeadaeahaaab
abaaacatarasatarasatarasatarasatarasatarasatarasatarasatarasatarasatarasatarasatarasatarbSaEarasatarasatarasatarasatarasatarasatarasatarasatarasatarasatarasatarasatarasatarasadaeadaeadaeadaeadaeafabaa
aaabagakbOajakaiajakaiajakaiajakaiajakaiajakaiajakaiajakaiajakaiajakaiajakaiajakaiajakaiajakaiajakaiajakaiajakaiajakaiajakaiajakaiajakaiajakaiajakaiajakaiajakaiajakaiajakaiajadaeadaeadaeadaeadaeahaaab
abaaacbebfbgaUbxbybzbzbzbzbzbzbzbzbzbzbzbzbzbzbzbzbzbzbzbzbzbzbzbzbzbzbzbzbxbybTayayazalapaqalbRayaybUbxbybVbVbVbVbVbVbVbVbVbVbVbVbVbVbVbVbVbVbVbVbVbVbVbVbVbVbVbVbxbyaVaUaVaUadaeadaeadaeadaeadaeafabaa
aaabagadaeadaeadaebCbDbCbDbCbDbCbDbCbDbCbDbCbDbCbDbCbDbCbDbCbDbCbDbCbDbCbDadaebWbXbYaEarasatarbSbZbXcaadaebCbDbCbDbCbDbCbDbCbDbCbDbCbDbCbDbCbDbCbDbCbDbCbDbCbDbCbDadaeadaeadaeadaeadaeadaeadaeadaeahaaab
abaaacadaeadaeadaeadaeadaeadaeadaeadaeadaeadaeadaeadaeadaeadaeadaeadaeadaeadaebmaiajakaiajakaiajakaibKadaeadaeadaeadaeadaeadaeadaeadaeadaeadaeadaeadaeadaeadaeadaeadaeadaeadaeadaeadaeadaeadaeadaeafabaa
aaabagadaeadaeadaeadaeadaeadaeadaeadaeadaeadaeadaeadaeadaeadaeadaeadaeadaeadaeboalapaqavayaycbapaqalbEadaeadaeadaeadaeadaeadaeadaeadaeadaeadaeadaeadaeadaeadaeadaeadaeadaeadaeadaeadaeadaeadaeadaeahaaab
abaaacadaeadaeadaeadaeadaeadaeadaeadaeadaeadaeadaeadaeadaeadaeadaeadaeadaeadaebkarasataAaBaCccasatarbHadaeadaeadaeadaeadaeadaeadaeadaeadaeadaeadaeadaeadaeadaeadaeadaeadaeadaeadaeadaeadaeadaeadaeafabaa
aaabagadaeadaeadaeadaeadaeadaeadaeadaeadaeadaeadaeadaeadaeadaeadaeadaeadaeadaebmaiajakaiajakaiajakaibKadaeadaeadaeadaeadaeadaeadaeadaeadaeadaeadaeadaeadaeadaeadaeadaeadaeadaeadaeadaeadaeadaeadaeahaaab
abaaacadaeadaeadaeadaeadaeadaeadaeadaeadaeadaeadaeadaeadaeadaeadaeadaeadaeadaebTayayazalapaqalbRayaybUadaeadaeadaeadaeadaeadaeadaeadaeadaeadaeadaeadaeadaeadaeadaeadaeadaeadaeadaeadaeadaeadaeadaeafabaa
aaabagadaeadaeadaeadaeadaeadaeadaeadaeadaeadaeadaeadaeadaeadaeadaeadaeadaeadaebWaDaBaEarasatarbSaCaDcaadaeadaeadaeadaeadaeadaeadaeadaeadaeadaeadaeadaeadaeadaeadaeadaeadaeadaeadaeadaeadaeadaeadaeahaaab
abaaacadaeadaeadaeadaeadaeadaeadaeadaeadaeadaeadaeadaeadaeadaeadaeadaeadaeadaeakaiajakaiajakaiajakaiajadaeadaeadaeadaeadaeadaeadaeadaeadaeadaeadaeadaeadaeadaeadaeadaeadaeadaeadaeadaeadaeadaeadaeafabaa
aaabagadaeadaeadaeadaeadaeadaeadaeadaeadaeadaeadaeadaeadaeadaeadaeadaeadaeadaeaqalapaqavayaycbapaqalapadaeadaeadaeadaeadaeadaeadaeadaeadaeadaeadaeadaeadaeadaeadaeadaeadaeadaeadaeadaeadaeadaeadaeahaaab
abaaacbWaDaBaCaDaBaCaDaBaCaDaBaCaDaBaCaDaBaCaDaBaCaDaBaCaDaBaCaDaBaCaDaBaCaDcaatarasataAaBaCccasatarasbWaDaBaCaDaBaCaDaBaCaDaBaCaDaBaCaDaBaCaDaBaCaDaBaCaDaBaCaDaBaCaDaBaCaDaBaCaDaBaCaDaBaCaDaBaEafabaa
aaabagakaiajakaiajakaiajakaiajakaiajakaiajakaiajakaiajakaiajakaiajakaiajakaiajakaiajakaiajakaiajakaiajakaiajakaiajakaiajakaiajakaiajakaiajakaiajakaiajakaiajakaiajakaiajakaiajakaiajakaiajakaiajakahaaab
abaaacaqalapaqalapaqalapaqalapaqalapaqalapaqalapaqalapaqalapaqalapaqalapaqalapaVaUaVaUaVaUaVaUaVaUaVaUaqalapaqalapaqalapaqalapaqalapaqalapaqalapaqalapaqalapaqalapaqalapaqalapaqalapaqalapaqalapaqafabaa
aaabagatarasatarasatarasatarasatarasatarasatarasatarasatarasatarasatarasataVaUadaeadaeadaeadaeadaeadaeaVaUasatarasatarasatarasatarasatarasatarasatarasatarasatarasatarasatarasatarasatarasatarasatahaaab
abaaacakaiajakaiajakaiajakaiajakaiajakaVaUaVaUaVaUaVaUaVaUaVaUaVaUaVaUaVaUadaeadaeadaeadaeadaeadaeadaeadaeaVaUaVaUaVaUaVaUaVaUakaiajakaiajakaiajakaiajakaiajakaiajakaiajakaiajakaiajakaiajakaiajakafabaa
aaabaganaoamaqalapaqalapaqalapaqalapbpadaeadaeadaeadaeadaeadaeadaeadaeadaeadaeadaeadaeadaeadaeadaeadaeadaeadaeadaeadaeadaeadaeboalapaqavbUaqalapaqalapaqalapaqalapaqalapaqalapaqalapaqalapaqaoamanahaaab
abaaacatarasatarasatarasatarasatarasbladaeadaeadaeadaeadaeadaeadaeadaeadaeadaebWaDaBaCaDaBaCaDaBaCaDcaadaeadaeadaeadaeadaeadaebkarasataAcaatarasatbvayayayayayayayaybuasatarasatarasatarasatarasatafabaa
aaabagakbOajakaiajakaiajakaiajakaiajbnadaeadaeadaeadaeadaeadaeadaeadaeadaeadaeakaiajakaiajakaiajakaiajadaeadaeadaeadaeadaeadaebmaiajakaiajakaiajakbAcdcecfcdcecfcdcebsajakaiajakaiajakaiajakaibPakahaaab
abaaacbebfbgaUavayayayayazalapaqalapaqbqaYaZaXaYaZaXaYaZaXaYaZaXaYaZaXaYaZaXbLaqalapaqalapaqalapaqalapaWaXaYaZaXaYaZaXaYaZaXbLaqalapaqalapaqalapaqalapaqalapaqalapaqalbRayayayayayayayaybUaVcgbgbfafabaa
aaabagadaeadaeaAaBaCaDaBaEarasatarasatarasatarasatarasatarasatarasatarasatarasatarasatarasatarasatarasatarasatarasatarasatarasatarasatarasatarasatarasatarasatarasatarbSaCaDaBaCaDaBaCaDcaadaeadaeahaaab
abaaacbrcfcdbJaiajakaiajakaiajakaiajakaiajakaiajakaiajakaiajakaiajakaiajakaiajaVaUaVaUaVaUaVaUaVaUaVaUakaiajakaiajchciajakcjckakaibMbNaiajchciajakcjayayayayayayayayciajakaiajakaiajakaiajbrcfcdbJafabaa
aaabagaqalapaqalapaqalapaqalapaqalapaqalapaqalapaqalapaqalapaqalapaqalapaqaVaUadaeadaeadaeadaeadaeadaeaVaUapaqalapaWbaapaqbqbLaqalbjbialapaWbaapaqbqaYaZaXaYaZaXaYaZbaapaqalapaqalapaqalapaqalapbpahaaab
abaaacatarasatarasatarasatarasatarasatarasatarasatarasatarasatarasataraVaUadaeadaeadaeadaeadaeadaeadaeadaeaVaUarasatarasatarasatarasatarasatarasatarasatarasatarasatarbFayayayayayayayaybwatarasblafabaa
aaabagakaiajakaiajakaiajakaiajakaiajakaiajakaiajakaiajakaiajakaiajaVaUadaeadaeadaeadaeadaeadaeadaeadaeadaeadaeaiajakaiajakaiajakaiajakaiajakaiajakaiajakaiajakaiajakaibIcecfcdcecfcdcecfbBakaiajbnahaaab
abaaacaqalapaqalapaqalapaqalapaqalapaqalapaqalapaqalapaqalapaqaVaUadaeadaeadaeadaeadaeadaeadaeadaeadaeboalapaqalapaqalapaqalapaqalapaqalapaqalapaqalapaqalapaqalapaqalapaqalapaqalapaqalapaqalapbpafabaa
aaabagatarasatarasatarasatarasatarasatarasatarasatarasataraVaUadaeadaeadaeadaeadaeadaeadaeadaeadaeadaebkarasatarasatarasatarasatarasatarasatarasatarasatarasatarasatarasatarasatarasatarasatarasblahaaab
clcmcnaVaUaVaUaVaUaVaUaVaUaVaUaVaUaVaUaVaUaVaUaVaUaVaUaVaUadaeadaeadaeadaeadaeadaeadaeadaeadaeadaeadaebVbVbVbVbVbVbVbVbVbVbVbVbVbVbVbVbxbybzbzbzbzbzbzbzbzbzbzbzbzbzbzbzbzbzbzbzbzbzbzbzbzbzbzbzbzclcmcn
clcmcnadaeadaeadaeadaeadaeadaeadaeadaeadaeadaeadaeadaeadaeadaeadaeadaeadaeadaeadaeadaeadaeadaeadaeadaebCbDbCbDbCbDbCbDbCbDbCbDbCbDbCbDadaebCbDbCbDbCbDbCbDbCbDbCbDbCbDbCbDbCbDbCbDbCbDbCbDbCbDbCbDclcmcn
clcmcnadaeadaeadaeadaeadaeadaeadaeadaeadaeadaeadaeadaeadaeadaeadaeadaeadaeadaeadaeadaeadaeadaeadaeadaeadaeadaeadaeadaeadaeadaeadaeadaeadaeadaeadaeadaeadaeadaeadaeadaeadaeadaeadaeadaeadaeadaeadaeclcmcn
clcmcnadaeadaeadaeadaeadaeadaeadaeadaeadaeadaeadaeadaeadaeadaeadaeadaeadaeadaeadaeadaeadaeadaeadaeadaeadaeadaeadaeadaeadaeadaeadaeadaeadaeadaeadaeadaeadaeadaeadaeadaeadaeadaeadaeadaeadaeadaeadaeclcmcn
"}
