"aa" = (/turf/TwinTowers/t20,/area)
"ab" = (/turf/TwinTowers/ttceiling/zero1,/area)
"ac" = (/turf/TwinTowers/ttceiling/one1,/area)
"ad" = (/turf/TwinTowers/ttceiling/two1,/area)
"ae" = (/turf/TwinTowers/ttceiling/three1,/area)
"af" = (/turf/TwinTowers/ttceiling/four1,/area)
"ag" = (/turf/TwinTowers/ttsky/BG51,/area)
"ah" = (/turf/TwinTowers/ttceiling/zero0,/area)
"ai" = (/turf/TwinTowers/ttceiling/one0,/area)
"aj" = (/turf/TwinTowers/ttceiling/two0,/area)
"ak" = (/turf/TwinTowers/ttceiling/three0,/area)
"al" = (/turf/TwinTowers/ttceiling/four0,/area)
"am" = (/turf/TwinTowers/ttback2/one1,/area)
"an" = (/turf/TwinTowers/ttback2/zero1,/area)
"ao" = (/turf/TwinTowers/ttback2/one0,/area)
"ap" = (/turf/TwinTowers/ttback2/zero0,/turf/RestrictionZones/NoShots/NoShoot,/area)
"aq" = (/turf/TwinTowers/ttback2/one0,/turf/RestrictionZones/NoShots/NoShoot,/area)
"ar" = (/turf/TwinTowers/ttback2/zero0,/area)
"as" = (/turf/TwinTowers/ttback2/zero1,/turf/RestrictionZones/NoShots/NoShootNoDense,/area)
"at" = (/turf/TwinTowers/ttback2/one1,/turf/SpawnPoints/TwinTowers/Spawn00,/area)
"au" = (/turf/TwinTowers/ttback2/one1,/turf/RestrictionZones/NoShots/NoShootNoDense,/area)
"av" = (/turf/TwinTowers/ttback2/zero1,/turf/SpawnPoints/TwinTowers/Spawn01,/area)
"aw" = (/turf/TwinTowers/ttback2/zero0,/turf/RestrictionZones/NoShots/NoShootNoDense,/area)
"ax" = (/turf/TwinTowers/ttback2/one0,/turf/RestrictionZones/NoShots/NoShootNoDense,/area)
"ay" = (/turf/TwinTowers/t3,/area)
"az" = (/turf/TwinTowers/t4,/turf/Capsules/Capsule,/turf/RestrictionZones/NoShots/NoShoot,/area)
"aA" = (/turf/TwinTowers/t5,/turf/RestrictionZones/NoShots/NoShoot,/area)
"aB" = (/turf/TwinTowers/t3,/turf/RestrictionZones/NoShots/NoShoot,/area)
"aC" = (/turf/TwinTowers/t4,/area)
"aD" = (/turf/TwinTowers/t5,/area)
"aE" = (/turf/TwinTowers/t5,/turf/Capsules/Capsule,/turf/RestrictionZones/NoShots/NoShoot,/area)
"aF" = (/turf/TwinTowers/t4,/turf/RestrictionZones/NoShots/NoShoot,/area)
"aG" = (/turf/TwinTowers/t6,/area)
"aH" = (/turf/TwinTowers/t7,/area)
"aI" = (/turf/TwinTowers/t8,/area)
"aJ" = (/turf/TwinTowers/ttsky/BG01,/area)
"aK" = (/turf/TwinTowers/ttsky/BG11,/area)
"aL" = (/turf/TwinTowers/ttsky/BG21,/area)
"aM" = (/turf/TwinTowers/ttsky/BG31,/area)
"aN" = (/turf/TwinTowers/ttsky/BG41,/area)
"aO" = (/turf/TwinTowers/ttsky/BG61,/area)
"aP" = (/turf/TwinTowers/ttsky/BG00,/area)
"aQ" = (/turf/TwinTowers/ttsky/BG10,/area)
"aR" = (/turf/TwinTowers/ttsky/BG20,/area)
"aS" = (/turf/TwinTowers/ttsky/BG30,/area)
"aT" = (/turf/TwinTowers/ttsky/BG40,/area)
"aU" = (/turf/TwinTowers/ttsky/BG50,/area)
"aV" = (/turf/TwinTowers/ttsky/BG60,/area)
"aW" = (/turf/TwinTowers/t10,/area)
"aX" = (/turf/TwinTowers/t12,/area)
"aY" = (/turf/TwinTowers/t9,/area)
"aZ" = (/turf/TwinTowers/t11,/area)
"ba" = (/turf/TwinTowers/ttback/zero1,/turf/TwinTowers/t19,/area)
"bb" = (/turf/TwinTowers/ttback/one1,/turf/TwinTowers/t19,/area)
"bc" = (/turf/TwinTowers/ttback/one1,/area)
"bd" = (/turf/TwinTowers/ttback/zero1,/area)
"be" = (/turf/TwinTowers/ttback/zero0,/area)
"bf" = (/obj/Switches/Door{DoorNumber = 1},/turf/TwinTowers/ttback/one0,/area)
"bg" = (/turf/TwinTowers/ttback/one0,/area)
"bh" = (/obj/Switches/Door{DoorNumber = 1},/turf/TwinTowers/ttback/zero0,/area)
"bi" = (/turf/TwinTowers/t13,/area)
"bj" = (/turf/TwinTowers/t14,/area)
"bk" = (/turf/TwinTowers/t15,/area)
"bl" = (/turf/TwinTowers/t16,/area)
"bm" = (/turf/TwinTowers/t17,/area)
"bn" = (/turf/TwinTowers/t18,/area)
"bo" = (/turf/TwinTowers/ttback2/zero1,/turf/SpawnPoints/TwinTowers/Spawn03,/area)
"bp" = (/turf/TwinTowers/t3,/turf/Capsules/Capsule,/turf/RestrictionZones/NoShots/NoShoot,/area)
"bq" = (/turf/TwinTowers/ttback2/zero1,/turf/SpawnPoints/TwinTowers/Spawn02,/area)
"br" = (/turf/TwinTowers/ttback2/one1,/turf/TwinTowers/t1,/area)
"bs" = (/turf/TwinTowers/ttback2/zero1,/turf/TwinTowers/t1,/area)
"bt" = (/turf/TwinTowers/t2,/area)

(1,1,1) = {"
aaaaaaaaaaaaaaaaabacadaeafabacadaeafabacadaeafabacadaeafabacadaeafabacadaeafaaaaagagagagagagagagagagagagagagagagagagagagaaaaabacadaeafabacadaeafabacadaeafabacadaeafabacadaeafabacadaeafaaaaaaaaaaaaaaaa
aaaaaaaaaaaaaaaaahaiajakalahaiajakalahaiajakalahaiajakalahaiajakalahaiajakalaaaaagagagagagagagagagagagagagagagagagagagagaaaaahaiajakalahaiajakalahaiajakalahaiajakalahaiajakalahaiajakalaaaaaaaaaaaaaaaa
aaaaaaaaaaaaaaaaaaamanamanamanamanamanamanamanamanamanamanamanamanamanamanaaaaaaagagagagagagagagagagagagagagagagagagagagaaaaaaamanamanamanamanamanamanamanamanamanamanamanamanamanamanaaaaaaaaaaaaaaaaaa
aaaaaaaaaaaaaaaaaaaoapaqapaoaraoaraoaraoaraoaraoaraoaraoaraoaraoaraoaraoaraaaaaaagagagagagagagagagagagagagagagagagagagagaaaaaaaoaraoaraoaraoaraoaraoaraoaraoaraoaraoaraoaraoaraqapaqaraaaaaaaaaaaaaaaaaa
aaaaaaaaaaaaaaaaaaamasatasamanamanamanamanamanamanamanamanamanamanamanamanaaaaaaagagagagagagagagagagagagagagagagagagagagaaaaaaamanamanamanamanamanamanamanamanamanamanamanamanauavauanaaaaaaaaaaaaaaaaaa
aaaaaaaaaaaaaaaaaaaoawaqawaoaraoaraoaraoaraoaraoaraoaraoaraoaraoaraoaraoaraaaaaaagagagagagagagagagagagagagagagagagagagagaaaaaaaoaraoaraoaraoaraoaraoaraoaraoaraoaraoaraoaraoaraxapaxaraaaaaaaaaaaaaaaaaa
aaaaaaaaaaaaaaaaaaayazaAaBaCaDayaCaDayaCaDamanamanamanamanamanamanamanamanaaaaaaagagagagagagagagagagagagagagagagagagagagaaaaaaamanamanamanamanamanamanamanamanayaCaDayaCaDayaCaEaBaFaDaaaaaaaaaaaaaaaaaa
aaaaaaaaaaaaaaaaaaaGaHaHaHaHaHaHaHaHaHaHaIaoaraoaraoaraoaraoaraoaraoaraoaraaaaaaagagagagagagagagagagagagagagagagagagagagaaaaaaaoaraoaraoaraoaraoaraoaraoaraoaraGaHaHaHaHaHaHaHaHaHaHaIaaaaaaaaaaaaaaaaaa
aaaaaaaaaaaaaaaaaaaaaaaaaaaaaaaaaaaaaaamanamanamanayaCaDanamanamanamanamanaaaaaaagagagagagagagagagagagagagagagagagagagagaaaaaaamanamanamanamanamanamanamayaCaDamanaaaaaaaaaaaaaaaaaaaaaaaaaaaaaaaaaaaaaa
aaaaaaaaaaaaaaaaaaaaaaaaaaaaaaaaaaaaaaaoaraoaraoaraGaHaIaraoaraoaraoaraoaraaaaaaagagagagagagagagagagagagagagagagagagagagaaaaaaaoaraoaraoaraoaraoaraoaraoaGaHaIaoaraaaaaaaaaaaaaaaaaaaaaaaaaaaaaaaaaaaaaa
aaaaaaaaaaaaaaaaaaaaaaaaaaaaaaaaaaaaaaamanamanamanamanamanayaCaDanamanamanaaaaaaagagagagagagagagagagagagagagagagagagagagaaaaaaamanamanamanamanamanayaCaDanamanamanaaaaaaaaaaaaaaaaaaaaaaaaaaaaaaaaaaaaaa
aaaaaaaaaaaaaaaaaaaaaaaaaaaaaaaaaaaaaaaoaraoaraoaraoaraoaraGaHaIaraoaraoaraaaaaaagagagagagagagagagagagagagagagagagagagagaaaaaaaoaraoaraoaraoaraoaraGaHaIaraoaraoaraaaaaaaaaaaaaaaaaaaaaaaaaaaaaaaaaaaaaa
aaaaaaaaaaaaaaaaaaaaaaaaaaaaaaaaaaaaaaamanamayaCaDamanamanamanamanamanamanaaaaaaagagagagagagagagagagagagagagagagagagagagaaaaaaamanamanamanamayaCaDamanamanamanamanaaaaaaaaaaaaaaaaaaaaaaaaaaaaaaaaaaaaaa
aaaaaaaaaaaaaaaaaaaaaaaaaaaaaaaaaaaaaaaoaraoaGaHaIaoaraoaraoaraoaraoaraoaraaaaaaagagagagagagagagagagagagagagagagagagagagaaaaaaaoaraoaraoaraoaGaHaIaoaraoaraoaraoaraaaaaaaaaaaaaaaaaaaaaaaaaaaaaaaaaaaaaa
aaaaaaaaaaaaaaaaaaaaaaaaaaaaaaaaaaaaaaamanamanamanamanamanamanamanayaCaDanaaaaaaagagagagagagagagagagagagagagagagagagagagaaaaaaamanamanayaCaDanamanamanamanamanamanaaaaaaaaaaaaaaaaaaaaaaaaaaaaaaaaaaaaaa
aaaaaaaaaaaaaaaaaaaaaaaaaaaaaaaaaaaaaaaoaraoaraoaraoaraoaraoaraoaraGaHaIaraaaaaaagagagagagagagagagagagagagagagagagagagagaaaaaaaoaraoaraGaHaIaraoaraoaraoaraoaraoaraaaaaaaaaaaaaaaaaaaaaaaaaaaaaaaaaaaaaa
aaaaaaaaaaaaaaaaaaaaaaaaaaaaaaaaaaaaaaayaCaDanamanamayaCaDamanamanamanamanaaaaaaagagagagagagagagagagagagagagagagagagagagaaaaaaamanamanamanamanamanamanamanamanamanaaaaaaaaaaaaaaaaaaaaaaaaaaaaaaaaaaaaaa
aaaaaaaaaaaaaaaaaaaaaaaaaaaaaaaaaaaaaaaGaHaIaraoaraoaGaHaIaoaraoaraoaraoaraaaaaaagagagagagagagagagagagagagagagagagagagagaaaaaaaoaraoaraoaraoaraoaraoaraoaraoaraoaraaaaaaaaaaaaaaaaaaaaaaaaaaaaaaaaaaaaaa
aaaaaaaaaaaaaaaaaaaaaaaaaaaaaaaaaaaaaaamanamanamanamanamanamanamanamanamanaaaaaaagagagagagagagagagagagagagagagagagagagagaaaaaaayaCaDanamanamanamanamanamanamanamanaaaaaaaaaaaaaaaaaaaaaaaaaaaaaaaaaaaaaa
aaaaaaaaaaaaaaaaaaaaaaaaaaaaaaaaaaaaaaaoaraoaraoaraoaraoaraoaraoaraoaraoaraaaaaaagagagagagagagagagagagagagagagagagagagagaaaaaaaGaHaIaraoaraoaraoaraoaraoaraoaraoaraaaaaaaaaaaaaaaaaaaaaaaaaaaaaaaaaaaaaa
aaaaaaaaaaaaaaaaaaaaaaaaaaaaaaaaaaaaaaamanamanamanamanamanamanamayaCaDamanaaaaaaagagagagagagagagagagagagagagagagagagagagaaaaaaamanamayaCaDayaCaDanamanamanamanamanaaaaaaaaaaaaaaaaaaaaaaaaaaaaaaaaaaaaaa
aaaaaaaaaaaaaaaaaaaaaaaaaaaaaaaaaaaaaaaoaraoaraoaraoaraoaraoaraoaGaHaIaoaraaaaaaagagagagagagagagagagagagagagagagagagagagaaaaaaaoaraoaGaHaIaGaHaIaraoaraoaraoaraoaraaaaaaaaaaaaaaaaaaaaaaaaaaaaaaaaaaaaaa
aaaaaaaaaaaaaaaaaaaaaaaaaaaaaaaaaaaaaaamanamayaCaDamanayaCaDanamanamanamanaaaaaaagagagagagagagagagagagagagagagagagagagagaaaaaaamanamanamanamanamayaCaDamanamanamanaaaaaaaaaaaaaaaaaaaaaaaaaaaaaaaaaaaaaa
aaaaaaaaaaaaaaaaaaaaaaaaaaaaaaaaaaaaaaaoaraoaGaHaIaoaraGaHaIaraoaraoaraoaraaaaaaagagagagagagagagagagagagagagagagagagagagaaaaaaaoaraoaraoaraoaraoaGaHaIaoaraoaraoaraaaaaaaaaaaaaaaaaaaaaaaaaaaaaaaaaaaaaa
aaaaaaaaaaaaaaaaaaaaaaaaaaaaaaaaaaaaaaamanamanamanamanamanamanamanamanamanaaaaaaagagagagagagagagagagagagagagagagagagagagaaaaaaamanamanamanamanamanamanamanamayaCaDaaaaaaaaaaaaaaaaaaaaaaaaaaaaaaaaaaaaaa
aaaaaaaaaaaaaaaaaaaaaaaaaaaaaaaaaaaaaaaoaraoaraoaraoaraoaraoaraoaraoaraoaraaaaaaagagagagagagagagagagagagagagagagagagagagaaaaaaaoaraoaraoaraoaraoaraoaraoaraoaGaHaIaaaaaaaaaaaaaaaaaaaaaaaaaaaaaaaaaaaaaa
aaaaaaaaaaaaaaaaaaaaaaaaaaaaaaaaaaaaaaamanamanamanamanamanamanamanamanamanaaaaaaaJaKaLaMaNagaOaJaKaLaMaNagaOaJaKaLaMaNagaaaaaaayaCaDanamanamanamayaCaDayaCaDanamanaaaaaaaaaaaaaaaaaaaaaaaaaaaaaaaaaaaaaa
aaaaaaaaaaaaaaaaaaaaaaaaaaaaaaaaaaaaaaaoaraoayaCaDayaCaDayaCaDaoaraoaraoaraaaaaaaPaQaRaSaTaUaVaPaQaRaSaTaUaVaPaQaRaSaTaUaaaaaaaGaHaIaraoaraoaraoaGaHaIaGaHaIaraoaraaaaaaaaaaaaaaaaaaaaaaaaaaaaaaaaaaaaaa
aaaaaaaaaaaaaaaaaaaaaaaaaaaaaaaaaaaaaaamanamaGaHaIaGaHaIaGaHaIamanamanamanaaaaaaaWaXabacadadadadadadadadadadadadaeafaWaXaaaaaaamanamanamanayaCaDanamanamanamanamanaaaaaaaaaaaaaaaaaaaaaaaaaaaaaaaaaaaaaa
aaaaaaaaaaaaaaaaaaaaaaaaaaaaaaaaaaaaaaaoaraoaraoaraoaraoaraoaraoaraoaraoaraaaaaaaYaZahaiajajajajajajajajajajajajakalaYaZaaaaaaaoaraoayaCaDaGaHaIaraoaraoaraoaraoaraaaaaaaaaaaaaaaaaaaaaaaaaaaaaaaaaaaaaa
aaaaaaaaaaaaaaaaaaaaaaaaaaaaaaaaaaaaaaamanamanamanamanamanamayaCaDamanamanbabbbabcbdbcbdbcbdbcbdbcbdbcbdbcbdbcbdbcbdbcbdbbbabbamanamaGaHaIamanamanamanamanamanamanaaaaaaaaaaaaaaaaaaaaaaaaaaaaaaaaaaaaaa
aaaaaaaaaaaaaaaaaaaaaaaaaaaaaaaaaaaaaaaoaraoaraoaraoaraoaraoaGaHaIaoaraoarbebfbebgbebgbebgbebgbebgbebgbebgbebgbebgbebgbebgbhbgaoaraoaraoaraoaraoaraoaraoaraoaraoaraaaaaaaaaaaaaaaaaaaaaaaaaaaaaaaaaaaaaa
aaaaaaaaaaaaaaaaaaaaaaaaaaaaaaaaaaaaaaayaCaDanamanamanamanamanamanamayaCaDbibjbjbjbjbjbjbjbjbjbjbjbjbjbjbjbjbjbjbjbjbjbjbjbjbkayaCaDanamanamanamanamanamanamanamanaaaaaaaaaaaaaaaaaaaaaaaaaaaaaaaaaaaaaa
aaaaaaaaaaaaaaaaaaaaaaaaaaaaaaaaaaaaaaaGaHaIaraoaraoaraoaraoaraoaraoaGaHaIblbmbmbmbmbmbmbmbmbmbmbmbmbmbmbmbmbmbmbmbmbmbmbmbmbnaGaHaIaraoaraoaraoaraoaraoaraoaraoaraaaaaaaaaaaaaaaaaaaaaaaaaaaaaaaaaaaaaa
aaaaaaaaaaaaaaaaaaaaaaaaaaaaaaaaaaaaaaamanamanamanamanamanamanamanamanamanaaaaaaagagagagagagagagagagagagagagagagagagagagaaaaaaamayaCaDamanamanamanamanamanamanamanaaaaaaaaaaaaaaaaaaaaaaaaaaaaaaaaaaaaaa
aaaaaaaaaaaaaaaaaaaaaaaaaaaaaaaaaaaaaaaoaraoaraoaraoaraoaraoaraoaraoaraoaraaaaaaagagagagagagagagagagagagagagagagagagagagaaaaaaaoaGaHaIaoaraoaraoaraoaraoaraoaraoaraaaaaaaaaaaaaaaaaaaaaaaaaaaaaaaaaaaaaa
aaaaaaaaaaaaaaaaaaaaaaaaaaaaaaaaaaaaaaamanamayaCaDayaCaDanamanamanamanamanaaaaaaagagagagagagagagagagagagagagagagagagagagaaaaaaamanamayaCaDayaCaDanamanayaCaDayaCaDaaaaaaaaaaaaaaaaaaaaaaaaaaaaaaaaaaaaaa
aaaaaaaaaaaaaaaaaaaaaaaaaaaaaaaaaaaaaaaoaraoaGaHaIaGaHaIaraoaraoaraoaraoaraaaaaaagagagagagagagagagagagagagagagagagagagagaaaaaaaoaraoaGaHaIaGaHaIaraoaraGaHaIaGaHaIaaaaaaaaaaaaaaaaaaaaaaaaaaaaaaaaaaaaaa
aaaaaaaaaaaaaaaaaaaaaaaaaaaaaaaaaaaaaaamanamanamanamanamanamanamanamanamanaaaaaaagagagagagagagagagagagagagagagagagagagagaaaaaaamanamanamanamanamanamanamanamanamanaaaaaaaaaaaaaaaaaaaaaaaaaaaaaaaaaaaaaa
aaaaaaaaaaaaaaaaaaaaaaaaaaaaaaaaaaaaaaaoaraoaraoaraoaraoaraoaraoaraoaraoaraaaaaaagagagagagagagagagagagagagagagagagagagagaaaaaaaoaraoaraoaraoaraoaraoaraoaraoaraoaraaaaaaaaaaaaaaaaaaaaaaaaaaaaaaaaaaaaaa
aaaaaaaaaaaaaaaaaaaaaaaaaaaaaaaaaaaaaaamanamanamanamanamayaCaDayaCaDanamanaaaaaaagagagagagagagagagagagagagagagagagagagagaaaaaaamanamanamanayaCaDayaCaDamanamanamanaaaaaaaaaaaaaaaaaaaaaaaaaaaaaaaaaaaaaa
aaaaaaaaaaaaaaaaaaaaaaaaaaaaaaaaaaaaaaaoaraoaraoaraoaraoaGaHaIaGaHaIaraoaraaaaaaagagagagagagagagagagagagagagagagagagagagaaaaaaaoaraoaraoaraGaHaIaGaHaIaoaraoaraoaraaaaaaaaaaaaaaaaaaaaaaaaaaaaaaaaaaaaaa
aaaaaaaaaaaaaaaaaaaaaaaaaaaaaaaaaaaaaaamanamanamanamanamanamanamanamanamanaaaaaaagagagagagagagagagagagagagagagagagagagagaaaaaaamanamanamanamanamanamanamanamanamanaaaaaaaaaaaaaaaaaaaaaaaaaaaaaaaaaaaaaa
aaaaaaaaaaaaaaaaaaaaaaaaaaaaaaaaaaaaaaaoaraoaraoaraoaraoaraoaraoaraoaraoaraaaaaaagagagagagagagagagagagagagagagagagagagagaaaaaaayaCaDayaCaDaoaraoaraoaraoaraoaraoaraaaaaaaaaaaaaaaaaaaaaaaaaaaaaaaaaaaaaa
aaaaaaaaaaaaaaaaaaaaaaaaaaaaaaaaaaaaaaamanamanamayaCaDayaCaDanamanamanamanaaaaaaagagagagagagagagagagagagagagagagagagagagaaaaaaaGaHaIaGaHaIamanamanamanamanamanamanaaaaaaaaaaaaaaaaaaaaaaaaaaaaaaaaaaaaaa
aaaaaaaaaaaaaaaaaaaaaaaaaaaaaaaaaaaaaaaoaraoaraoaGaHaIaGaHaIaraoaraoaraoaraaaaaaagagagagagagagagagagagagagagagagagagagagaaaaaaaoaraoaraoaraoaraoaraoaraoaraoaraoaraaaaaaaaaaaaaaaaaaaaaaaaaaaaaaaaaaaaaa
aaaaaaaaaaaaaaaaaaaaaaaaaaaaaaaaaaaaaaamanamanamanamanamanamanamanamanamanaaaaaaagagagagagagagagagagagagagagagagagagagagaaaaaaamanamanamanayaCaDayaCaDamanamanamanaaaaaaaaaaaaaaaaaaaaaaaaaaaaaaaaaaaaaa
aaaaaaaaaaaaaaaaaaaaaaaaaaaaaaaaaaaaaaaoaraoaraoaraoaraoaraoaraoaraoaraoaraaaaaaagagagagagagagagagagagagagagagagagagagagaaaaaaaoaraoaraoaraGaHaIaGaHaIaoaraoaraoaraaaaaaaaaaaaaaaaaaaaaaaaaaaaaaaaaaaaaa
aaaaaaaaaaaaaaaaaaaaaaaaaaaaaaaaaaaaaaayaCaDanamanamanamanamanamanamanamanaaaaaaagagagagagagagagagagagagagagagagagagagagaaaaaaamanamanamanamanamanamanamanamanamanaaaaaaaaaaaaaaaaaaaaaaaaaaaaaaaaaaaaaa
aaaaaaaaaaaaaaaaaaaaaaaaaaaaaaaaaaaaaaaGaHaIaraoaraoaraoaraoaraoaraoaraoaraaaaaaagagagagagagagagagagagagagagagagagagagagaaaaaaaoaraoaraoaraoaraoaraoaraoaraoayaCaDaaaaaaaaaaaaaaaaaaaaaaaaaaaaaaaaaaaaaa
aaaaaaaaaaaaaaaaaaaaaaaaaaaaaaaaaaaaaaamanamanamanamanamanamanamanamayaCaDaaaaaaagagagagagagagagagagagagagagagagagagagagaaaaaaamanamanamayaCaDamanayaCaDanamaGaHaIaaaaaaaaaaaaaaaaaaaaaaaaaaaaaaaaaaaaaa
aaaaaaaaaaaaaaaaaaaaaaaaaaaaaaaaaaaaaaaoaraoaraoaraoaraoaraoaraoaraoaGaHaIaaaaaaagagagagagagagagagagagagagagagagagagagagaaaaaaayaCaDaraoaGaHaIaoaraGaHaIaraoaraoaraaaaaaaaaaaaaaaaaaaaaaaaaaaaaaaaaaaaaa
aaaaaaaaaaaaaaaaaaaaaaaaaaaaaaaaaaaaaaamanamayaCaDayaCaDanamanamanamanamanaaaaaaagagagagagagagagagagagagagagagagagagagagaaaaaaaGaHaIanamanamanamanamanamanamanamanaaaaaaaaaaaaaaaaaaaaaaaaaaaaaaaaaaaaaa
aaaaaaaaaaaaaaaaaaaaaaaaaaaaaaaaaaaaaaaoaraoaGaHaIaGaHaIaraoaraoaraoaraoaraaaaaaagagagagagagagagagagagagagagagagagagagagaaaaaaaoaraoaraoaraoaraoaraoaraoaraoaraoaraaaaaaaaaaaaaaaaaaaaaaaaaaaaaaaaaaaaaa
aaaaaaaaaaaaaaaaaaaaaaaaaaaaaaaaaaaaaaamanamanamanamanamanamayaCaDamanamanaaaaaaagagagagagagagagagagagagagagagagagagagagaaaaaaamayaCaDamanamanamanamanamanamanamanaaaaaaaaaaaaaaaaaaaaaaaaaaaaaaaaaaaaaa
aaaaaaaaaaaaaaaaaaaaaaaaaaaaaaaaaaaaaaaoaraoaraoaraoaraoaraoaGaHaIaoaraoaraaaaaaagagagagagagagagagagagagagagagagagagagagaaaaaaaoaGaHaIayaCaDaraoaraoaraoaraoaraoaraaaaaaaaaaaaaaaaaaaaaaaaaaaaaaaaaaaaaa
aaaaaaaaaaaaaaaaaaaaaaaaaaaaaaaaaaaaaaamanamanamanamanayaCaDanamanamanamanaaaaaaagagagagagagagagagagagagagagagagagagagagaaaaaaamanamanaGaHaIayaCaDamanamanamanamanaaaaaaaaaaaaaaaaaaaaaaaaaaaaaaaaaaaaaa
aaaaaaaaaaaaaaaaaaaaaaaaaaaaaaaaaaaaaaaoaraoaraoaraoaraGaHaIaraoaraoaraoaraaaaaaagagagagagagagagagagagagagagagagagagagagaaaaaaaoaraoaraoaraoaGaHaIayaCaDaraoaraoaraaaaaaaaaaaaaaaaaaaaaaaaaaaaaaaaaaaaaa
aaaaaaaaaaaaaaaaaaaaaaaaaaaaaaaaaaaaaaamanamanamanamanamanamanamanamanamanaaaaaaagagagagagagagagagagagagagagagagagagagagaaaaaaamanamanamanamanamanaGaHaIanamayaCaDaaaaaaaaaaaaaaaaaaaaaaaaaaaaaaaaaaaaaa
aaaaaaaaaaaaaaaaaaaaaaaaaaaaaaaaaaaaaaaoaraoaraoaraoaraoaraoaraoaraoaraoaraaaaaaagagagagagagagagagagagagagagagagagagagagaaaaaaaoaraoaraoaraoaraoaraoaraoaraoaGaHaIaaaaaaaaaaaaaaaaaaaaaaaaaaaaaaaaaaaaaa
aaaaaaaaaaaaaaaaaaaaaaaaaaaaaaaaaaaaaaayaCaDayaCaDayaCaDanamanamanamanamanaaaaaaagagagagagagagagagagagagagagagagagagagagaaaaaaamanamanamanamanamanamanamanamanamanaaaaaaaaaaaaaaaaaaaaaaaaaaaaaaaaaaaaaa
aaaaaaaaaaaaaaaaaaaaaaaaaaaaaaaaaaaaaaaGaHaIaGaHaIaGaHaIaraoaraoaraoaraoaraaaaaaagagagagagagagagagagagagagagagagagagagagaaaaaaaoaraoarayaCaDaraoaraoaraoayaCaDaoaraaaaaaaaaaaaaaaaaaaaaaaaaaaaaaaaaaaaaa
aaaaaaaaaaaaaaaaaaaaaaaaaaaaaaaaaaaaaaamanamanamanamanamanamanamanamanamanaaaaaaagagagagagagagagagagagagagagagagagagagagaaaaaaamanamanaGaHaIayaCaDayaCaDaGaHaIamanaaaaaaaaaaaaaaaaaaaaaaaaaaaaaaaaaaaaaa
aaaaaaaaaaaaaaaaaaaaaaaaaaaaaaaaaaaaaaaoaraoaraoaraoaraoaraoaraoaraoaraoaraaaaaaagagagagagagagagagagagagagagagagagagagagaaaaaaaoaraoaraoaraoaGaHaIaGaHaIaraoaraoaraaaaaaaaaaaaaaaaaaaaaaaaaaaaaaaaaaaaaa
aaaaaaaaaaaaaaaaaaaaaaaaaaaaaaaaaaaaaaamanamanamanayaCaDanamanamanamayaCaDaaaaaaaJaKaLaMaNagaOaJaKaLaMaNagaOaJaKaLaMaNagaaaaaaayaCaDanamanamanamanamanamanamanamanaaaaaaaaaaaaaaaaaaaaaaaaaaaaaaaaaaaaaa
aaaaaaaaaaaaaaaaaaaaaaaaaaaaaaaaaaaaaaaoaraoaraoaraGaHaIaraoaraoaraoaGaHaIaaaaaaaPaQaRaSaTaUaVaPaQaRaSaTaUaVaPaQaRaSaTaUaaaaaaaGaHaIayaCaDaoaraoaraoaraoaraoaraoaraaaaaaaaaaaaaaaaaaaaaaaaaaaaaaaaaaaaaa
aaaaaaaaaaaaaaaaaaaaaaaaaaaaaaaaaaaaaaamanamanamanamanamayaCaDayaCaDanamanaaaaaaaWaXabacadadadadadadadadadadadadaeafaWaXaaaaaaamanamaGaHaIamanamanamanamanamanamanaaaaaaaaaaaaaaaaaaaaaaaaaaaaaaaaaaaaaa
aaaaaaaaaaaaaaaaaaaaaaaaaaaaaaaaaaaaaaaoaraoaraoaraoaraoaGaHaIaGaHaIaraoaraaaaaaaYaZahaiajajajajajajajajajajajajakalaYaZaaaaaaaoaraoaraoaraoaraoaraoaraoaraoaraoaraaaaaaaaaaaaaaaaaaaaaaaaaaaaaaaaaaaaaa
aaaaaaaaaaaaaaaaaaaaaaaaaaaaaaaaaaaaaaamanamayaCaDamanamanamanamanamanamanbabbbabcbdbcbdbcbdbcbdbcbdbcbdbcbdbcbdbcbdbcbdbbbabbamanamanamayaCaDayaCaDayaCaDamanamanaaaaaaaaaaaaaaaaaaaaaaaaaaaaaaaaaaaaaa
aaaaaaaaaaaaaaaaaaaaaaaaaaaaaaaaaaaaaaaoaraoaGaHaIaoaraoaraoaraoaraoaraoarbebfbebgbebgbebgbebgbebgbebgbebgbebgbebgbebgbebgbhbgaoaraoaraoaGaHaIaGaHaIaGaHaIaoaraoaraaaaaaaaaaaaaaaaaaaaaaaaaaaaaaaaaaaaaa
aaaaaaaaaaaaaaaaaaaaaaaaaaaaaaaaaaaaaaamanamanamanamanamanamanamanamayaCaDbibjbjbjbjbjbjbjbjbjbjbjbjbjbjbjbjbjbjbjbjbjbjbjbjbkayaCaDanamanamanamanamanamanamanamanaaaaaaaaaaaaaaaaaaaaaaaaaaaaaaaaaaaaaa
aaaaaaaaaaaaaaaaaaaaaaaaaaaaaaaaaaaaaaaoaraoaraoaraoaraoaraoaraoaraoaGaHaIblbmbmbmbmbmbmbmbmbmbmbmbmbmbmbmbmbmbmbmbmbmbmbmbmbnaGaHaIaraoaraoaraoaraoaraoaraoaraoaraaaaaaaaaaaaaaaaaaaaaaaaaaaaaaaaaaaaaa
aaaaaaaaaaaaaaaaaaaaaaaaaaaaaaaaaaaaaaayaCaDanamanamanamanamanayaCaDanamanaaaaaaagagagagagagagagagagagagagagagagagagagagaaaaaaamanamanamanamanamanamanamanamanamanaaaaaaaaaaaaaaaaaaaaaaaaaaaaaaaaaaaaaa
aaaaaaaaaaaaaaaaaaaaaaaaaaaaaaaaaaaaaaaGaHaIaraoaraoaraoaraoaraGaHaIaraoaraaaaaaagagagagagagagagagagagagagagagagagagagagaaaaaaaoarayaCaDaraoaraqapaqaraoaraoaraoaraaaaaaaaaaaaaaaaaaaaaaaaaaaaaaaaaaaaaa
aaaaaaaaaaaaaaaaaaaaaaaaaaaaaaaaaaaaaaamanamayaCaDayaCaDanamanamanamanamanaaaaaaagagagagagagagagagagagagagagagagagagagagaaaaaaamanaGaHaIanamanauboauanamanamanamanaaaaaaaaaaaaaaaaaaaaaaaaaaaaaaaaaaaaaa
aaaaaaaaaaaaaaaaaaaaaaaaaaaaaaaaaaaaaaaoaraoaGaHaIaGaHaIaraoaraoaraoaraoaraaaaaaagagagagagagagagagagagagagagagagagagagagaaaaaaaoaraoaraoaraoaraxapaxaraoaraoaraoaraaaaaaaaaaaaaaaaaaaaaaaaaaaaaaaaaaaaaa
aaaaaaaaaaaaaaaaaaaaaaaaaaaaaaaaaaaaaaamanamanamanamanamayaCaDamanamanamanaaaaaaagagagagagagagagagagagagagagagagagagagagaaaaaaamanamanamayaCaDbpaFaAanamanamanamanaaaaaaaaaaaaaaaaaaaaaaaaaaaaaaaaaaaaaa
aaaaaaaaaaaaaaaaaaaaaaaaaaaaaaaaaaaaaaaoaraoaraoaraoaraoaGaHaIaoaraoaraoaraaaaaaagagagagagagagagagagagagagagagagagagagagaaaaaaaoaraoaraoaGaHaIaGaHaIaraoaraoaraoaraaaaaaaaaaaaaaaaaaaaaaaaaaaaaaaaaaaaaa
aaaaaaaaaaaaaaaaaaaaaaaaaaaaaaaaaaaaaaamanamanamanamanamanamanamanamanamanaaaaaaagagagagagagagagagagagagagagagagagagagagaaaaaaamanamanamanamanamanamanamanamayaCaDaaaaaaaaaaaaaaaaaaaaaaaaaaaaaaaaaaaaaa
aaaaaaaaaaaaaaaaaaaaaaaaaaaaaaaaaaaaaaaoaraoaraoaraoaraoaraoarayaCaDaraoaraaaaaaagagagagagagagagagagagagagagagagagagagagaaaaaaaoaraoaraoaraoaraoaraoaraoaraoaGaHaIaaaaaaaaaaaaaaaaaaaaaaaaaaaaaaaaaaaaaa
aaaaaaaaaaaaaaaaaaaaaaaaaaaaaaaaaaaaaaamanamanamanamanamanamanaGaHaIanamanaaaaaaagagagagagagagagagagagagagagagagagagagagaaaaaaamanamanamanamanamanamanamanamanamanaaaaaaaaaaaaaaaaaaaaaaaaaaaaaaaaaaaaaa
aaaaaaaaaaaaaaaaaaaaaaaaaaaaaaaaaaaaaaaoaraoaraoaraqapaqaraoaraoaraoaraoaraaaaaaagagagagagagagagagagagagagagagagagagagagaaaaaaaoaraoaraoaraoaraoaraoaraoaraoaraoaraaaaaaaaaaaaaaaaaaaaaaaaaaaaaaaaaaaaaa
aaaaaaaaaaaaaaaaaaaaaaaaaaaaaaaaaaaaaaamanamanamanaubqauanamanamanamayaCaDaaaaaaagagagagagagagagagagagagagagagagagagagagaaaaaaamanamayaCaDamanamayaCaDayaCaDanamanaaaaaaaaaaaaaaaaaaaaaaaaaaaaaaaaaaaaaa
aaaaaaaaaaaaaaaaaaaaaaaaaaaaaaaaaaaaaaaoaraoaraoaraxapaxaraoaraoaraoaGaHaIaaaaaaagagagagagagagagagagagagagagagagagagagagaaaaaaaoaraoaGaHaIaoaraoaGaHaIaGaHaIaraoaraaaaaaaaaaaaaaaaaaaaaaaaaaaaaaaaaaaaaa
aaaaaaaaaaaaaaaaaaaaaaaaaaaaaaaaaaaaaaamanamanamanbpaFaAayaCaDamanamanamanaaaaaaagagagagagagagagagagagagagagagagagagagagaaaaaaamanamanamanamanamanamanamanamanamanaaaaaaaaaaaaaaaaaaaaaaaaaaaaaaaaaaaaaa
aaaaaaaaaaaaaaaaaaaaaaaaaaaaaaaaaaaaaaaoaraoaraoaraGaHaIaGaHaIaoaraoaraoaraaaaaaagagagagagagagagagagagagagagagagagagagagaaaaaaaoaraoaraoaraoaraoaraoaraoaraoaraoaraaaaaaaaaaaaaaaaaaaaaaaaaaaaaaaaaaaaaa
aaaaaaaaaaaaaaaaaaaaaaaaaaaaaaaaaaaaaaamanamanamanamanamanamanamanamanamanaaaaaaagagagagagagagagagagagagagagagagagagagagaaaaaaamanamanamanayaCaDayaCaDamanamayaCaDaaaaaaaaaaaaaaaaaaaaaaaaaaaaaaaaaaaaaa
aaaaaaaaaaaaaaaaaaaaaaaaaaaaaaaaaaaaaaayaCaDaraoaraoaraoaraoaraoayaCaDaoaraaaaaaagagagagagagagagagagagagagagagagagagagagaaaaaaaoaraoaraoaraGaHaIaGaHaIaoaraoaGaHaIaaaaaaaaaaaaaaaaaaaaaaaaaaaaaaaaaaaaaa
aaaaaaaaaaaaaaaaaaaaaaaaaaaaaaaaaaaaaaaGaHaIanamanamanamanamanamaGaHaIamanaaaaaaagagagagagagagagagagagagagagagagagagagagaaaaaaamanamanamanamanamanamanamanamanamanaaaaaaaaaaaaaaaaaaaaaaaaaaaaaaaaaaaaaa
aaaaaaaaaaaaaaaaaaaaaaaaaaaaaaaaaaaaaaaoaraoaraoaraoaraoaraoaraoaraoaraoaraaaaaaagagagagagagagagagagagagagagagagagagagagaaaaaaaoaraoaraoaraoaraoaraoaraoaraoaraoaraaaaaaaaaaaaaaaaaaaaaaaaaaaaaaaaaaaaaa
aaaaaaaaaaaaaaaaaaaaaaaaaaaaaaaaaaaaaaamanamanamanamanamanamanamanamanamanaaaaaaagagagagagagagagagagagagagagagagagagagagaaaaaaayaCaDayaCaDamanamayaCaDayaCaDanamanaaaaaaaaaaaaaaaaaaaaaaaaaaaaaaaaaaaaaa
aaaaaaaaaaaaaaaaaaaaaaaaaaaaaaaaaaaaaaaoaraoayaCaDayaCaDaraoayaCaDaoaraoaraaaaaaagagagagagagagagagagagagagagagagagagagagaaaaaaaGaHaIaGaHaIaoaraoaGaHaIaGaHaIaraoaraaaaaaaaaaaaaaaaaaaaaaaaaaaaaaaaaaaaaa
aaaaaaaaaaaaaaaaaaaaaaaaaaaaaaaaaaaaaaamanamaGaHaIaGaHaIanamaGaHaIamanamanaaaaaaagagagagagagagagagagagagagagagagagagagagaaaaaaamanamanamanamanamanamanamanamanamanaaaaaaaaaaaaaaaaaaaaaaaaaaaaaaaaaaaaaa
aaaaaaaaaaaaaaaaaaaaaaaaaaaaaaaaaaaaaaaoaraoaraoaraoaraoaraoaraoaraoaraoaraaaaaaagagagagagagagagagagagagagagagagagagagagaaaaaaaoaraoaraoaraoaraoaraoaraoaraoaraoaraaaaaaaaaaaaaaaaaaaaaaaaaaaaaaaaaaaaaa
aaaaaaaaaaaaaaaaaaaaaaaaaaaaaaaaaaaaaaamanamanamanamanamanamanamanamanamanaaaaaaagagagagagagagagagagagagagagagagagagagagaaaaaaamanamanamanamanamanamanamanamanamanaaaaaaaaaaaaaaaaaaaaaaaaaaaaaaaaaaaaaa
aaaaaaaaaaaaaaaaaaaaaaaaaaaaaaaaaaaaaaaoaraoaraoaraoaraoaraoaraoaraoaraoaraaaaaaagagagagagagagagagagagagagagagagagagagagaaaaaaaoaraoaraoaraoaraoaraoaraoaraoaraoaraaaaaaaaaaaaaaaaaaaaaaaaaaaaaaaaaaaaaa
aaaaaaaaaaaaaaaaaaaaaaaaaaaaaaaaaaaaaabrbsbrbsbrbsbrbsbrbsbrbsbrbsbrbsbrbsaaaaaaagagagagagagagagagagagagagagagagagagagagaaaaaabrbsbrbsbrbsbrbsbrbsbrbsbrbsbrbsbrbsaaaaaaaaaaaaaaaaaaaaaaaaaaaaaaaaaaaaaa
aaaaaaaaaaaaaaaaaaaaaaaaaaaaaaaaaaaaaabtbtbtbtbtbtbtbtbtbtbtbtbtbtbtbtbtbtaaaaaaagagagagagagagagagagagagagagagagagagagagaaaaaabtbtbtbtbtbtbtbtbtbtbtbtbtbtbtbtbtbtaaaaaaaaaaaaaaaaaaaaaaaaaaaaaaaaaaaaaa
aaaaaaaaaaaaaaaaaaaaaaaaaaaaaaaaaaaaaaaaaaaaaaaaaaaaaaaaaaaaaaaaaaaaaaaaaaaaaaaaagagagagagagagagagagagagagagagagagagagagaaaaaaaaaaaaaaaaaaaaaaaaaaaaaaaaaaaaaaaaaaaaaaaaaaaaaaaaaaaaaaaaaaaaaaaaaaaaaaaa
aaaaaaaaaaaaaaaaaaaaaaaaaaaaaaaaaaaaaaaaaaaaaaaaaaaaaaaaaaaaaaaaaaaaaaaaaaaaaaaaagagagagagagagagagagagagagagagagagagagagaaaaaaaaaaaaaaaaaaaaaaaaaaaaaaaaaaaaaaaaaaaaaaaaaaaaaaaaaaaaaaaaaaaaaaaaaaaaaaaa
"}
