"aa" = (/turf/TwinTowers/t20,/area)
"ab" = (/turf/TwinTowers/ttceiling/zero1,/area)
"ac" = (/turf/TwinTowers/ttceiling/one1,/area)
"ad" = (/turf/TwinTowers/ttceiling/two1,/area)
"ae" = (/turf/TwinTowers/ttceiling/three1,/area)
"af" = (/turf/TwinTowers/ttceiling/four1,/area)
"ag" = (/turf,/area)
"ah" = (/turf/TwinTowers/ttceiling/zero0,/area)
"ai" = (/turf/TwinTowers/ttceiling/one0,/area)
"aj" = (/turf/TwinTowers/ttceiling/two0,/area)
"ak" = (/turf/TwinTowers/ttceiling/three0,/area)
"al" = (/turf/TwinTowers/ttceiling/four0,/area)
"am" = (/turf/TwinTowers/back2{tag = ""; icon_state = "0,1"},/area)
"an" = (/turf/TwinTowers/back2{tag = ""; icon_state = "1,1"},/area)
"ao" = (/turf/TwinTowers/back2{tag = ""; icon_state = "0,0"},/area)
"ap" = (/turf/TwinTowers/back2{tag = ""; icon_state = "1,0"},/area)
"aq" = (/turf/TwinTowers/back2{tag = ""; icon_state = "0,0"},/turf/NoBarrier,/area)
"ar" = (/turf/TwinTowers/back2{tag = ""; icon_state = "1,0"},/turf/Dense,/area)
"as" = (/turf/TwinTowers/back2{tag = ""; icon_state = "0,0"},/turf/Dense,/area)
"at" = (/turf/TwinTowers/back2{tag = ""; icon_state = "0,1"},/turf/NoBarrier,/area)
"au" = (/turf/TwinTowers/back2{tag = ""; icon_state = "0,1"},/turf/FlagPoint,/area)
"av" = (/turf/TwinTowers/t3,/area)
"aw" = (/turf/TwinTowers/t4,/area)
"ax" = (/turf/TwinTowers/t5,/area)
"ay" = (/turf/TwinTowers/t3,/turf/Dense,/turf/Capsules/Capsule,/area)
"az" = (/turf/TwinTowers/t4,/turf/Dense,/area)
"aA" = (/turf/TwinTowers/t5,/turf/Dense,/area)
"aB" = (/turf/TwinTowers/t6,/area)
"aC" = (/turf/TwinTowers/t7,/area)
"aD" = (/turf/TwinTowers/t8,/area)
"aE" = (/turf/TwinTowers/t10,/area)
"aF" = (/turf/TwinTowers/t12,/area)
"aG" = (/turf/TwinTowers/t9,/area)
"aH" = (/turf/TwinTowers/t11,/area)
"aI" = (/turf/TwinTowers/back{tag = ""; icon_state = "0,1"},/turf/TwinTowers/t19,/area)
"aJ" = (/turf/TwinTowers/back{tag = ""; icon_state = "1,1"},/turf/TwinTowers/t19,/area)
"aK" = (/turf/TwinTowers/back{tag = ""; icon_state = "0,1"},/area)
"aL" = (/turf/TwinTowers/back{tag = ""; icon_state = "1,1"},/area)
"aM" = (/turf/TwinTowers/back{tag = ""; icon_state = "0,0"},/area)
"aN" = (/obj/Switches/Door{DoorNumber = 1},/turf/TwinTowers/back{tag = ""; icon_state = "1,0"},/area)
"aO" = (/turf/TwinTowers/back{tag = ""; icon_state = "1,0"},/area)
"aP" = (/obj/Switches/Door{DoorNumber = 1},/turf/TwinTowers/back{tag = ""; icon_state = "0,0"},/area)
"aQ" = (/turf/TwinTowers/t13,/area)
"aR" = (/turf/TwinTowers/t14,/area)
"aS" = (/turf/TwinTowers/t15,/area)
"aT" = (/turf/TwinTowers/t16,/area)
"aU" = (/turf/TwinTowers/t17,/area)
"aV" = (/turf/TwinTowers/t18,/area)
"aW" = (/turf/TwinTowers/back2{tag = ""; icon_state = "1,0"},/turf/NoBarrier,/area)
"aX" = (/turf/TwinTowers/back2{tag = ""; icon_state = "1,1"},/turf/NoBarrier,/area)
"aY" = (/turf/TwinTowers/back2{tag = ""; icon_state = "1,1"},/turf/FlagPoint,/area)
"aZ" = (/turf/TwinTowers/back2{tag = ""; icon_state = "0,1"},/turf/Dense,/area)
"ba" = (/turf/TwinTowers/back2{tag = ""; icon_state = "1,1"},/turf/Dense,/area)
"bb" = (/turf/TwinTowers/back2{tag = ""; icon_state = "1,0"},/turf/FlagPoint,/area)
"bc" = (/turf/TwinTowers/back2{tag = ""; icon_state = "0,1"},/turf/TwinTowers/t1,/area)
"bd" = (/turf/TwinTowers/back2{tag = ""; icon_state = "1,1"},/turf/TwinTowers/t1,/area)
"be" = (/turf/TwinTowers/t2,/area)

(1,1,1) = {"
aaaaaaaaaaaaaaaaaaaaaaaaaaaaaaaaaaaaaaabacadaeafabacadaeafabacadaeafabacadaeafaaaaaaagagagagagagagagagagagagagagagagaaaaabacadaeafabacadaeafabacadaeafabacadaeafabacadaeafaaaaaaaaaaaaaaaaaaaaaaaaaaaaaa
aaaaaaaaaaaaaaaaaaaaaaaaaaaaaaaaaaaaaaahaiajakalahaiajakalahaiajakalahaiajakalaaaaaaagagagagagagagagagagagagagagagagaaaaahaiajakalahaiajakalahaiajakalahaiajakalahaiajakalaaaaaaaaaaaaaaaaaaaaaaaaaaaaaa
aaaaaaaaaaaaaaaaaaaaaaaaaaaaaaaaaaaaaaaaamanamanamanamanamanamanamanamanamanaaaaaaaaagagagagagagagagagagagagagagagagaaaaaaaaanamanamanamanamanamanamanamanamanamanamanaaaaaaaaaaaaaaaaaaaaaaaaaaaaaaaaaa
aaaaaaaaaaaaaaaaaaaaaaaaaaaaaaaaaaaaaaaaaoapaoapaoapaoapaoapaoapaoapaoapaoapaaaaaaaaagagagagagagagagagagagagagagagagaaaaaaaaapaoapaoapaoapaoapaoapaoapaoapaoapaoapaoapaaaaaaaaaaaaaaaaaaaaaaaaaaaaaaaaaa
aaaaaaaaaaaaaaaaaaaaaaaaaaaaaaaaaaaaaaaaamanamanamanamanamanamanamanamanamanaaaaaaaaagagagagagagagagagagagagagagagagaaaaaaaaanamanamanamanamanamanamanamanamanamanamanaaaaaaaaaaaaaaaaaaaaaaaaaaaaaaaaaa
aaaaaaaaaaaaaaaaaaaaaaaaaaaaaaaaaaaaaaaaaoapaoapaqarasaraqapaoapaoapaoapaoapaaaaaaaaagagagagagagagagagagagagagagagagaaaaaaaaapaoapaoapaoapaoapaoapaoapaqarasaraqapaoapaaaaaaaaaaaaaaaaaaaaaaaaaaaaaaaaaa
aaaaaaaaaaaaaaaaaaaaaaaaaaaaaaaaaaaaaaaaamanamanatanauanatanamanamanamanamanaaaaaaaaagagagagagagagagagagagagagagagagaaaaaaaaanamanamanamanamanamanamanatanauanatanamanaaaaaaaaaaaaaaaaaaaaaaaaaaaaaaaaaa
aaaaaaaaaaaaaaaaaaaaaaaaaaaaaaaaaaaaaaaaaoapaoapaqapasapaqapaoapaoapaoapaoapaaaaaaaaagagagagagagagagagagagagagagagagaaaaaaaaapaoapaoapaoapaoapaoapaoapaqapasapaqapaoapaaaaaaaaaaaaaaaaaaaaaaaaaaaaaaaaaa
aaaaaaaaaaaaaaaaaaaaaaaaaaaaaaaaaaaaaaaaamanavawaxayazaAavawaxanamanamanamanaaaaaaaaagagagagagagagagagagagagagagagagaaaaaaaaanamanamanamanamanamanavawaxayazaAavawaxanaaaaaaaaaaaaaaaaaaaaaaaaaaaaaaaaaa
aaaaaaaaaaaaaaaaaaaaaaaaaaaaaaaaaaaaaaaaaoapaBaCaCaCaCaCaCaCaDapaoapaoapaoapaaaaaaaaagagagagagagagagagagagagagagagagaaaaaaaaapaoapaoapaoapaoapaoapaBaCaCaCaCaCaCaCaDapaaaaaaaaaaaaaaaaaaaaaaaaaaaaaaaaaa
aaaaaaaaaaaaaaaaaaaaaaaaaaaaaaaaaaaaaaaaamanamanamanamanamanamanamanamanamanaaaaaaaaagagagagagagagagagagagagagagagagaaaaaaaaanamanamanavawaxanamanamanamanamanamanamanaaaaaaaaaaaaaaaaaaaaaaaaaaaaaaaaaa
aaaaaaaaaaaaaaaaaaaaaaaaaaaaaaaaaaaaaaaaaoapaoapaoapaoapaoapaoapaoapaoapaoapaaaaaaaaagagagagagagagagagagagagagagagagaaaaaaaaapaoapaoapaBaCaDapaoapaoapaoapaoapaoapaoapaaaaaaaaaaaaaaaaaaaaaaaaaaaaaaaaaa
aaaaaaaaaaaaaaaaaaaaaaaaaaaaaaaaaaaaaaaaamanamanamanamanamanamanamavawaxamanaaaaaaaaagagagagagagagagagagagagagagagagaaaaaaaaanamanamanamanamanamanamanamanamanamanamanaaaaaaaaaaaaaaaaaaaaaaaaaaaaaaaaaa
aaaaaaaaaaaaaaaaaaaaaaaaaaaaaaaaaaaaaaaaaoapaoapaoapaoapaoapaoapaoaBaCaDaoapaaaaaaaaagagagagagagagagagagagagagagagagaaaaaaaaapaoapaoapaoapaoapaoapaoapaoapaoapaoapaoapaaaaaaaaaaaaaaaaaaaaaaaaaaaaaaaaaa
aaaaaaaaaaaaaaaaaaaaaaaaaaaaaaaaaaaaaaaaamanamanamanamanamanamanamanamanamanaaaaaaaaagagagagagagagagagagagagagagagagaaaaaaaaanamanamanamanamanamanamanamanamanamanamanaaaaaaaaaaaaaaaaaaaaaaaaaaaaaaaaaa
aaaaaaaaaaaaaaaaaaaaaaaaaaaaaaaaaaaaaaaaaoapaoapaoapaoapaoapaoapaoapaoapaoapaaaaaaaaagagagagagagagagagagagagagagagagaaaaaaaaapaoapaoapaoapaoapaoapaoapaoapaoapaoapaoapaaaaaaaaaaaaaaaaaaaaaaaaaaaaaaaaaa
aaaaaaaaaaaaaaaaaaaaaaaaaaaaaaaaaaaaaaaaamanamanamanamanamanamanamanamanamanaaaaaaaaagagagagagagagagagagagagagagagagaaaaaaaaanamanamanamanamanamanamanamanamanamanamanaaaaaaaaaaaaaaaaaaaaaaaaaaaaaaaaaa
aaaaaaaaaaaaaaaaaaaaaaaaaaaaaaaaaaaaaaaaaoapaoapaoapaoapaoapaoapaoapaoapaoapaaaaaaaaagagagagagagagagagagagagagagagagaaaaaaaaapaoapaoapaoapaoapaoapaoapaoapaoapaoapaoapaaaaaaaaaaaaaaaaaaaaaaaaaaaaaaaaaa
aaaaaaaaaaaaaaaaaaaaaaaaaaaaaaaaaaaaaaaaamanamavawaxamanamanamanamanamanamanaaaaaaaaagagagagagagagagagagagagagagagagaaaaaaaaanamanamanamanamanamanamanamanamanamanamanaaaaaaaaaaaaaaaaaaaaaaaaaaaaaaaaaa
aaaaaaaaaaaaaaaaaaaaaaaaaaaaaaaaaaaaaaaaaoapaoaBaCaDaoapaoapaoapaoapaoapaoapaaaaaaaaagagagagagagagagagagagagagagagagaaaaaaaaapaoapaoapaoapaoapaoapaoapaoapaoapaoapaoapaaaaaaaaaaaaaaaaaaaaaaaaaaaaaaaaaa
aaaaaaaaaaaaaaaaaaaaaaaaaaaaaaaaaaaaaaaaamanamanamanamanamanamanamanamanamanaaaaaaaaagagagagagagagagagagagagagagagagaaaaaaaaanamanamanamanamanamanamanamanamanamanamanaaaaaaaaaaaaaaaaaaaaaaaaaaaaaaaaaa
aaaaaaaaaaaaaaaaaaaaaaaaaaaaaaaaaaaaaaaaaoapaoapaoapaoavawaxaoapaoapaoapaoapaaaaaaaaagagagagagagagagagagagagagagagagaaaaaaaaapaoapaoavawaxaoapaoapaoapaoapaoapaoapaoapaaaaaaaaaaaaaaaaaaaaaaaaaaaaaaaaaa
aaaaaaaaaaaaaaaaaaaaaaaaaaaaaaaaaaaaaaaaamanamanamanamaBaCaDamanamanamanamanaaaaaaaaagagagagagagagagagagagagagagagagaaaaaaaaanamanamaBaCaDavawaxanamanamanamanamanamanaaaaaaaaaaaaaaaaaaaaaaaaaaaaaaaaaa
aaaaaaaaaaaaaaaaaaaaaaaaaaaaaaaaaaaaaaaaaoapaoapaoapaoapaoapaoapaoapaoapaoapaaaaaaaaagagagagagagagagagagagagagagagagaaaaaaaaapaoapaoapaoapaBaCaDavawaxaoapaoapaoapaoapaaaaaaaaaaaaaaaaaaaaaaaaaaaaaaaaaa
aaaaaaaaaaaaaaaaaaaaaaaaaaaaaaaaaaaaaaaaamanamanamanamanamanamanamanamanamanaaaaaaaaagagagagagagagagagagagagagagagagaaaaaaaaanamanamanamanamanamaBaCaDavawaxanamanamanaaaaaaaaaaaaaaaaaaaaaaaaaaaaaaaaaa
aaaaaaaaaaaaaaaaaaaaaaaaaaaaaaaaaaaaaaaaaoapavawaxapaoapaoapaoapaoavawaxaoapaaaaaaaaagagagagagagagagagagagagagagagagaaaaaaaaapaoapaoapaoapaoapaoapaoapaBaCaDavawaxaoapaaaaaaaaaaaaaaaaaaaaaaaaaaaaaaaaaa
aaaaaaaaaaaaaaaaaaaaaaaaaaaaaaaaaaaaaaaaamanaBaCaDanamanamanamanamaBaCaDamanaaaaaaaaagagagagagagagagagagagagagagagagaaaaaaaaanamanamanamanamanamanamanamanamaBaCaDamanaaaaaaaaaaaaaaaaaaaaaaaaaaaaaaaaaa
aaaaaaaaaaaaaaaaaaaaaaaaaaaaaaaaaaaaaaaaaoapaoapaoapaoapaoapaoapaoapaoapaoapaaaaaaaaagagagagagagagagagagagagagagagagaaaaaaaaapaoapaoapaoapaoapaoapaoapaoapaoapaoapaoapaaaaaaaaaaaaaaaaaaaaaaaaaaaaaaaaaa
aaaaaaaaaaaaaaaaaaaaaaaaaaaaaaaaaaaaaaaaamanamanamanamanamanamanamanamanamanaaaaaaaaaEaFabacadaeafaEaFabacadaeafaEaFaaaaaaaaanamanamanamanamanamanamanamanamanamanamanaaaaaaaaaaaaaaaaaaaaaaaaaaaaaaaaaa
aaaaaaaaaaaaaaaaaaaaaaaaaaaaaaaaaaaaaaaaaoapaoapaoapaoapaoapaoapaoapaoapaoapaaaaaaaaaGaHahaiajakalaGaHahaiajakalaGaHaaaaaaaaapaoapaoapaoapaoapaoapaoapaoapaoapaoapaoapaaaaaaaaaaaaaaaaaaaaaaaaaaaaaaaaaa
aaaaaaaaaaaaaaaaaaaaaaaaaaaaaaaaaaaaaaaaamanamanamanamavawaxamanamanamanamanaIaJaIaJaKaLaKaLaKaLaKaLaKaLaKaLaKaLaKaLaIaJaIaJanamanamanamanamanamanamanamanamanamanamanaaaaaaaaaaaaaaaaaaaaaaaaaaaaaaaaaa
aaaaaaaaaaaaaaaaaaaaaaaaaaaaaaaaaaaaaaaaaoapaoapaoapaoaBaCaDaoapaoapaoapaoapaMaNaMaOaMaOaMaOaMaOaMaOaMaOaMaOaMaOaMaOaMaOaPaOapaoapaoapaoapaoapaoapavawaxapaoapaoapaoapaaaaaaaaaaaaaaaaaaaaaaaaaaaaaaaaaa
aaaaaaaaaaaaaaaaaaaaaaaaaaaaaaaaaaaaaaaaamanamanamanamanamanamanamanamavawaxaQaRaSaQaRaSaQaRaSaQaRaSaQaRaSaQaRaSaQaRaSaQaRaSavawaxamanamanamanamanaBaCaDanamanamanamanaaaaaaaaaaaaaaaaaaaaaaaaaaaaaaaaaa
aaaaaaaaaaaaaaaaaaaaaaaaaaaaaaaaaaaaaaaaaoapaoapaoapaoapaoapaoapaoapaoaBaCaDaTaUaUaUaUaUaUaUaUaUaUaUaUaUaUaUaUaUaUaUaUaUaUaVaBaCaDaoapaoapaoapaoapaoapaoapaoapaoapaoapaaaaaaaaaaaaaaaaaaaaaaaaaaaaaaaaaa
aaaaaaaaaaaaaaaaaaaaaaaaaaaaaaaaaaaaaaaaamanamanamanamanamanamanamanamanamanaaaaaaaaagagagagagagagagagagagagagagagagaaaaaaaaanamanamanamanamanamanamanamanamanamanamanaaaaaaaaaaaaaaaaaaaaaaaaaaaaaaaaaa
aaaaaaaaaaaaaaaaaaaaaaaaaaaaaaaaaaaaaaaaaoapaoapavawaxapaoapaoapaoapaoapaoapaaaaaaaaagagagagagagagagagagagagagagagagaaaaaaaaapaoapaoapavawaxapaoapaoapaoapaoapaoavawaxaaaaaaaaaaaaaaaaaaaaaaaaaaaaaaaaaa
aaaaaaaaaaaaaaaaaaaaaaaaaaaaaaaaaaaaaaaaamanamanaBaCaDanamanamanamanamanamanaaaaaaaaagagagagagagagagagagagagagagagagaaaaaaaaanamanamanaBaCaDanamanamanamanamanamaBaCaDaaaaaaaaaaaaaaaaaaaaaaaaaaaaaaaaaa
aaaaaaaaaaaaaaaaaaaaaaaaaaaaaaaaaaaaaaaaaoapaoapaoapaoapaoapaoapaoapaoapaoapaaaaaaaaagagagagagagagagagagagagagagagagaaaaaaaaapaoapaoapaoapaoapaoapaoapaoapaoapaoapaoapaaaaaaaaaaaaaaaaaaaaaaaaaaaaaaaaaa
aaaaaaaaaaaaaaaaaaaaaaaaaaaaaaaaaaaaaaaaamanamanamanamanamanamanamanamanamanaaaaaaaaagagagagagagagagagagagagagagagagaaaaaaaaanamanamanamanamanamanamanamanamanamanamanaaaaaaaaaaaaaaaaaaaaaaaaaaaaaaaaaa
aaaaaaaaaaaaaaaaaaaaaaaaaaaaaaaaaaaaaaaaaoapaoapaoapaoavawaxaoapaoapaoapaoapaaaaaaaaagagagagagagagagagagagagagagagagaaaaaaaaapaoapaoapaoapaoapaoapaoapaoapaoapaoapaoapaaaaaaaaaaaaaaaaaaaaaaaaaaaaaaaaaa
aaaaaaaaaaaaaaaaaaaaaaaaaaaaaaaaaaaaaaaaamanamanamanamaBaCaDamanamanamanamanaaaaaaaaagagagagagagagagagagagagagagagagaaaaaaaaanamanamanamanamanamanamanamanamanamanamanaaaaaaaaaaaaaaaaaaaaaaaaaaaaaaaaaa
aaaaaaaaaaaaaaaaaaaaaaaaaaaaaaaaaaaaaaaaaoapaoapaoapaoapaoapaoapaoapaoapaoapaaaaaaaaagagagagagagagagagagagagagagagagaaaaaaaaapaoapaoapaoapaoapaoapaoapaoapaoapaoapaoapaaaaaaaaaaaaaaaaaaaaaaaaaaaaaaaaaa
aaaaaaaaaaaaaaaaaaaaaaaaaaaaaaaaaaaaaaaaamanamanamanamanamanamanamanamanamanaaaaaaaaagagagagagagagagagagagagagagagagaaaaaaaaanamanamanamanamanamanamanamanamanamanamanaaaaaaaaaaaaaaaaaaaaaaaaaaaaaaaaaa
aaaaaaaaaaaaaaaaaaaaaaaaaaaaaaaaaaaaaaaaaoapaoapaoapaoapaoapaoavawaxaoapaoapaaaaaaaaagagagagagagagagagagagagagagagagaaaaaaaaapaoapaoapaoapaoapaoapaoapaoapaoapaoapaoapaaaaaaaaaaaaaaaaaaaaaaaaaaaaaaaaaa
aaaaaaaaaaaaaaaaaaaaaaaaaaaaaaaaaaaaaaaaamanamanamanamanamanamaBaCaDamanamanaaaaaaaaagagagagagagagagagagagagagagagagaaaaaaaaanamanavawaxanamanamanamanamanavawaxanamanaaaaaaaaaaaaaaaaaaaaaaaaaaaaaaaaaa
aaaaaaaaaaaaaaaaaaaaaaaaaaaaaaaaaaaaaaaaaoapaoapaoapaoapaoapaoapaoapaoapaoapaaaaaaaaagagagagagagagagagagagagagagagagaaaaaaaaapaoapaBaCaDapaoapaoapaoapaoapaBaCaDapaoapaaaaaaaaaaaaaaaaaaaaaaaaaaaaaaaaaa
aaaaaaaaaaaaaaaaaaaaaaaaaaaaaaaaaaaaaaaaamanamanamanamanamanamanamanamanamanaaaaaaaaagagagagagagagagagagagagagagagagaaaaaaaaanamanamanamavawaxamanamavawaxamanamanamanaaaaaaaaaaaaaaaaaaaaaaaaaaaaaaaaaa
aaaaaaaaaaaaaaaaaaaaaaaaaaaaaaaaaaaaaaaaaoapaoapaoapaoapaoapaoapaoapaoapaoapaaaaaaaaagagagagagagagagagagagagagagagagaaaaaaaaapaoapaoapaoaBaCaDaoapaoaBaCaDaoapaoapaoapaaaaaaaaaaaaaaaaaaaaaaaaaaaaaaaaaa
aaaaaaaaaaaaaaaaaaaaaaaaaaaaaaaaaaaaaaaaavawaxanamanavawaxavawaxamanamavawaxaaaaaaaaagagagagagagagagagagagagagagagagaaaaaaaaavawaxamanamanamanavawaxanamanamanamavawaxaaaaaaaaaaaaaaaaaaaaaaaaaaaaaaaaaa
aaaaaaaaaaaaaaaaaaaaaaaaaaaaaaaaaaaaaaaaaBaCaDapaoapaBaCaDaBaCaDaoapaoaBaCaDaaaaaaaaagagagagagagagagagagagagagagagagaaaaaaaaaBaCaDaoapaoapaoapaBaCaDapaoapaoapaoaBaCaDaaaaaaaaaaaaaaaaaaaaaaaaaaaaaaaaaa
aaaaaaaaaaaaaaaaaaaaaaaaaaaaaaaaaaaaaaaaamanamanamanamanamanamanamanamanamanaaaaaaaaagagagagagagagagagagagagagagagagaaaaaaaaanamanamanamavawaxamanamavawaxamanamanamanaaaaaaaaaaaaaaaaaaaaaaaaaaaaaaaaaa
aaaaaaaaaaaaaaaaaaaaaaaaaaaaaaaaaaaaaaaaaoapaoapaoapaoapaoapaoapaoapaoapaoapaaaaaaaaagagagagagagagagagagagagagagagagaaaaaaaaapaoapaoapaoaBaCaDaoapaoaBaCaDaoapaoapaoapaaaaaaaaaaaaaaaaaaaaaaaaaaaaaaaaaa
aaaaaaaaaaaaaaaaaaaaaaaaaaaaaaaaaaaaaaaaamanamanamanamanamanamanamanamanamanaaaaaaaaagagagagagagagagagagagagagagagagaaaaaaaaanamanavawaxanamanamanamanamanavawaxanamanaaaaaaaaaaaaaaaaaaaaaaaaaaaaaaaaaa
aaaaaaaaaaaaaaaaaaaaaaaaaaaaaaaaaaaaaaaaaoapaoapaoapaoapaoapaoapaoapaoapaoapaaaaaaaaagagagagagagagagagagagagagagagagaaaaaaaaapaoapaBaCaDapaoaWasarasaWaoapaBaCaDapaoapaaaaaaaaaaaaaaaaaaaaaaaaaaaaaaaaaa
aaaaaaaaaaaaaaaaaaaaaaaaaaaaaaaaaaaaaaaaamanamanamanamanamanamanamanamanamanaaaaaaaaagagagagagagagagagagagagagagagagaaaaaaaaanamanamanamanamaXamaYamaXamanamanamanamanaaaaaaaaaaaaaaaaaaaaaaaaaaaaaaaaaa
aaaaaaaaaaaaaaaaaaaaaaaaaaaaaaaaaaaaaaaaaoapaoapaoapaoapaoapaoapaoapaoapaoapaaaaaaaaagagagagagagagagagagagagagagagagaaaaaaaaapaoapaoapaoapaoaWaoaraoaWaoapaoapaoapaoapaaaaaaaaaaaaaaaaaaaaaaaaaaaaaaaaaa
aaaaaaaaaaaaaaaaaaaaaaaaaaaaaaaaaaaaaaaaamanamanamanamanamanamanamanamanamanaaaaaaaaagagagagagagagagagagagagagagagagaaaaaaaaanamanamanamanamanayazaAanamanamanamanamanaaaaaaaaaaaaaaaaaaaaaaaaaaaaaaaaaa
aaaaaaaaaaaaaaaaaaaaaaaaaaaaaaaaaaaaaaaaaoapaoapaoapaoapaoapaoapaoapaoapaoapaaaaaaaaagagagagagagagagagagagagagagagagaaaaaaaaapaoapaoapaoapaoapaBaCaDapaoapaoapaoapaoapaaaaaaaaaaaaaaaaaaaaaaaaaaaaaaaaaa
aaaaaaaaaaaaaaaaaaaaaaaaaaaaaaaaaaaaaaaaamanamanamanamanamanamanamanamanamanaaaaaaaaagagagagagagagagagagagagagagagagaaaaaaaaanamanamanamanamanamanamanamanamanamanamanaaaaaaaaaaaaaaaaaaaaaaaaaaaaaaaaaa
aaaaaaaaaaaaaaaaaaaaaaaaaaaaaaaaaaaaaaaaaoapaoapaoapaoapaoapaoapaoapaoapaoapaaaaaaaaagagagagagagagagagagagagagagagagaaaaaaaaapaoapaoapaoapaoapaoapaoapaoapaoapaoapaoapaaaaaaaaaaaaaaaaaaaaaaaaaaaaaaaaaa
aaaaaaaaaaaaaaaaaaaaaaaaaaaaaaaaaaaaaaaaamanamanamanamanamanamanamanamanamanaaaaaaaaagagagagagagagagagagagagagagagagaaaaaaaaanamanamanamanamanamanamanamanamanamanamanaaaaaaaaaaaaaaaaaaaaaaaaaaaaaaaaaa
aaaaaaaaaaaaaaaaaaaaaaaaaaaaaaaaaaaaaaaaaoapaoapaoapaoapaoapaoapaoapaoapaoapaaaaaaaaagagagagagagagagagagagagagagagagaaaaaaaaapaoapaoapavawaxapaoapaoapavawaxapaoapaoapaaaaaaaaaaaaaaaaaaaaaaaaaaaaaaaaaa
aaaaaaaaaaaaaaaaaaaaaaaaaaaaaaaaaaaaaaaaamanamanamanamanamanamanamanamanamanaaaaaaaaagagagagagagagagagagagagagagagagaaaaaaaaanamanamanaBaCaDanamanamanaBaCaDanamanamanaaaaaaaaaaaaaaaaaaaaaaaaaaaaaaaaaa
aaaaaaaaaaaaaaaaaaaaaaaaaaaaaaaaaaaaaaaaaoapaoapaoapaoapaoapaoapaoapaoapaoapaaaaaaaaagagagagagagagagagagagagagagagagaaaaaaaaapaoapaoapaoapaoapaoapaoapaoapaoapaoapaoapaaaaaaaaaaaaaaaaaaaaaaaaaaaaaaaaaa
aaaaaaaaaaaaaaaaaaaaaaaaaaaaaaaaaaaaaaaaamanamanamanamanamanamanamanamanamanaaaaaaaaagagagagagagagagagagagagagagagagaaaaaaaaanamanamanamanamanavawaxanamanamanamanamanaaaaaaaaaaaaaaaaaaaaaaaaaaaaaaaaaa
aaaaaaaaaaaaaaaaaaaaaaaaaaaaaaaaaaaaaaaaaoapaoapaoapaoapaoapaoapaoapaoapaoapaaaaaaaaagagagagagagagagagagagagagagagagaaaaaaaaapaoapaoapaoapaoapaBaCaDapaoapaoapaoapaoapaaaaaaaaaaaaaaaaaaaaaaaaaaaaaaaaaa
aaaaaaaaaaaaaaaaaaaaaaaaaaaaaaaaaaaaaaaaamanamanamanamanamanamanamanamanamanaaaaaaaaagagagagagagagagagagagagagagagagaaaaaaaaanamanamanamanamanamanamanamanamanamanamanaaaaaaaaaaaaaaaaaaaaaaaaaaaaaaaaaa
aaaaaaaaaaaaaaaaaaaaaaaaaaaaaaaaaaaaaaaaaoapaoapaoapaoapaoapaoapaoapaoapaoapaaaaaaaaagagagagagagagagagagagagagagagagaaaaaaaaapaoapaoapaoapaoapaoapaoapaoapaoapaoapaoapaaaaaaaaaaaaaaaaaaaaaaaaaaaaaaaaaa
aaaaaaaaaaaaaaaaaaaaaaaaaaaaaaaaaaaaaaaaamanamanavawaxanamanavawaxanamanamanaaaaaaaaagagagagagagagagagagagagagagagagaaaaaaaaanamanamanamanamanamanamanamanamanamanamanaaaaaaaaaaaaaaaaaaaaaaaaaaaaaaaaaa
aaaaaaaaaaaaaaaaaaaaaaaaaaaaaaaaaaaaaaaaaoapaoapaBaCaDapaoapaBaCaDapaoapaoapaaaaaaaaagagagagagagagagagagagagagagagagaaaaaaaaapaoapaoapaoapaoapaoapaoapaoapaoapaoapaoapaaaaaaaaaaaaaaaaaaaaaaaaaaaaaaaaaa
aaaaaaaaaaaaaaaaaaaaaaaaaaaaaaaaaaaaaaaaamanamanamanamavawaxamanamanamanamanaaaaaaaaagagagagagagagagagagagagagagagagaaaaaaaaanamanamanamanamanamanamanamanamanamanamanaaaaaaaaaaaaaaaaaaaaaaaaaaaaaaaaaa
aaaaaaaaaaaaaaaaaaaaaaaaaaaaaaaaaaaaaaaaaoavawaxaoapaoaBaCaDaoapaoavawaxaoapaaaaaaaaagagagagagagagagagagagagagagagagaaaaaaaaapaoapaoapaoapaoapaoapaoapaoapaoapaoapaoapaaaaaaaaaaaaaaaaaaaaaaaaaaaaaaaaaa
aaaaaaaaaaaaaaaaaaaaaaaaaaaaaaaaaaaaaaaaamaBaCaDavawaxanamanavawaxaBaCaDamanaaaaaaaaagagagagagagagagagagagagagagagagaaaaaaaaanamavawaxamanamanamanamavawaxamanamanamanaaaaaaaaaaaaaaaaaaaaaaaaaaaaaaaaaa
aaaaaaaaaaaaaaaaaaaaaaaaaaaaaaaaaaaaaaaaaoapaoapaBaCaDapaoapaBaCaDapaoapaoapaaaaaaaaagagagagagagagagagagagagagagagagaaaaaaaaapaoaBaCaDaoapaoapaoapaoaBaCaDaoapaoapaoapaaaaaaaaaaaaaaaaaaaaaaaaaaaaaaaaaa
aaaaaaaaaaaaaaaaaaaaaaaaaaaaaaaaaaaaaaaaamanamanamanamanamanamanamanamanamanaaaaaaaaagagagagagagagagagagagagagagagagaaaaaaaaanamanamanamanamanamanamanamanamanamanamanaaaaaaaaaaaaaaaaaaaaaaaaaaaaaaaaaa
aaaaaaaaaaaaaaaaaaaaaaaaaaaaaaaaaaaaaaaaaoapaoapaoapaoapaoapaoapaoapaoapaoapaaaaaaaaagagagagagagagagagagagagagagagagaaaaaaaaapaoapaoapaoapavawaxapaoapaoapaoapavawaxapaaaaaaaaaaaaaaaaaaaaaaaaaaaaaaaaaa
aaaaaaaaaaaaaaaaaaaaaaaaaaaaaaaaaaaaaaaaamanamanamanamanamanamanamanamanamanaaaaaaaaagagagagagagagagagagagagagagagagaaaaaaaaanamanamanamanaBaCaDanamanamanamanaBaCaDanaaaaaaaaaaaaaaaaaaaaaaaaaaaaaaaaaa
aaaaaaaaaaaaaaaaaaaaaaaaaaaaaaaaaaaaaaaaaoapaoapaoapaoapaoapaoapaoapaoapaoapaaaaaaaaagagagagagagagagagagagagagagagagaaaaaaaaapaoapaoapaoapaoapaoapaoapaoapaoapaoapaoapaaaaaaaaaaaaaaaaaaaaaaaaaaaaaaaaaa
aaaaaaaaaaaaaaaaaaaaaaaaaaaaaaaaaaaaaaaaamanamanamanamanamanamanamanamanamanaaaaaaaaagagagagagagagagagagagagagagagagaaaaaaaaanamavawaxamanamanamanamavawaxamanamanamanaaaaaaaaaaaaaaaaaaaaaaaaaaaaaaaaaa
aaaaaaaaaaaaaaaaaaaaaaaaaaaaaaaaaaaaaaaaaoapaoapaoapaoapaoapaoapaoapaoapaoapaaaaaaaaagagagagagagagagagagagagagagagagaaaaaaaaapaoaBaCaDaoapaoapaoapaoaBaCaDaoapaoapaoapaaaaaaaaaaaaaaaaaaaaaaaaaaaaaaaaaa
aaaaaaaaaaaaaaaaaaaaaaaaaaaaaaaaaaaaaaaaamanamanamanamanamanamanamanamanamanaaaaaaaaagagagagagagagagagagagagagagagagaaaaaaaaanamanamanamanamanamanamanamanamanamanamanaaaaaaaaaaaaaaaaaaaaaaaaaaaaaaaaaa
aaaaaaaaaaaaaaaaaaaaaaaaaaaaaaaaaaaaaaaaaoapaoapaoapaoapaoapaoapaoapaoapaoapaaaaaaaaagagagagagagagagagagagagagagagagaaaaaaaaapaoapaoapaoapavawaxapaoapaoapaoapavawaxapaaaaaaaaaaaaaaaaaaaaaaaaaaaaaaaaaa
aaaaaaaaaaaaaaaaaaaaaaaaaaaaaaaaaaaaaaaaamanamanamanamanamanamanamanamanamanaaaaaaaaagagagagagagagagagagagagagagagagaaaaaaaaanamanamanamanaBaCaDanamanamanamanaBaCaDanaaaaaaaaaaaaaaaaaaaaaaaaaaaaaaaaaa
aaaaaaaaaaaaaaaaaaaaaaaaaaaaaaaaaaaaaaaaavawaxapaoavawaxaoapavawaxapaoavawaxaaaaaaaaagagagagagagagagagagagagagagagagaaaaaaaaapaoapaoapaoapaoapaoapaoapaoapaoapaoapaoapaaaaaaaaaaaaaaaaaaaaaaaaaaaaaaaaaa
aaaaaaaaaaaaaaaaaaaaaaaaaaaaaaaaaaaaaaaaaBaCaDanamaBaCaDamanaBaCaDanamaBaCaDaaaaaaaaagagagagagagagagagagagagagagagagaaaaaaaaanamavawaxamanamanamanamavawaxamanamanamanaaaaaaaaaaaaaaaaaaaaaaaaaaaaaaaaaa
aaaaaaaaaaaaaaaaaaaaaaaaaaaaaaaaaaaaaaaaaoapaoapaoapaoapaoapaoapaoapaoapaoapaaaaaaaaagagagagagagagagagagagagagagagagaaaaaaaaapaoaBaCaDaoapaoapaoapaoaBaCaDaoapaoapaoapaaaaaaaaaaaaaaaaaaaaaaaaaaaaaaaaaa
aaaaaaaaaaaaaaaaaaaaaaaaaaaaaaaaaaaaaaaaamanamaXaZbaaZaXamanamanamanamanamanaaaaaaaaagagagagagagagagagagagagagagagagaaaaaaaaanamanamanamanamanamanamanamanamanamanamanaaaaaaaaaaaaaaaaaaaaaaaaaaaaaaaaaa
aaaaaaaaaaaaaaaaaaaaaaaaaaaaaaaaaaaaaaaaaoapaoaWaobbaoaWaoapaoapaoapaoapaoapaaaaaaaaagagagagagagagagagagagagagagagagaaaaaaaaapaoapaoapaoapavawaxapaoapaoapaoapavawaxapaaaaaaaaaaaaaaaaaaaaaaaaaaaaaaaaaa
aaaaaaaaaaaaaaaaaaaaaaaaaaaaaaaaaaaaaaaaamanamaXambaamaXamanamanamanamanamanaaaaaaaaagagagagagagagagagagagagagagagagaaaaaaaaanamanamanamanaBaCaDanamanamanamanaBaCaDanaaaaaaaaaaaaaaaaaaaaaaaaaaaaaaaaaa
aaaaaaaaaaaaaaaaaaaaaaaaaaaaaaaaaaaaaaaaaoapaoapayazaAapaoapaoapaoapaoapaoapaaaaaaaaagagagagagagagagagagagagagagagagaaaaaaaaapaoapaoapaoapaoapaoapaoapaoapaoapaoapaoapaaaaaaaaaaaaaaaaaaaaaaaaaaaaaaaaaa
aaaaaaaaaaaaaaaaaaaaaaaaaaaaaaaaaaaaaaaaamanamanaBaCaDanamanamanamanamanamanaaaaaaaaagagagagagagagagagagagagagagagagaaaaaaaaanamavawaxamanamanamanamavawaxamanamanamanaaaaaaaaaaaaaaaaaaaaaaaaaaaaaaaaaa
aaaaaaaaaaaaaaaaaaaaaaaaaaaaaaaaaaaaaaaaaoapaoapaoapaoapaoapaoapaoapaoapaoapaaaaaaaaagagagagagagagagagagagagagagagagaaaaaaaaapaoaBaCaDaoapaoapaoapaoaBaCaDaoapaoapaoapaaaaaaaaaaaaaaaaaaaaaaaaaaaaaaaaaa
aaaaaaaaaaaaaaaaaaaaaaaaaaaaaaaaaaaaaaaaamanamanamanamanamanamanamanamanamanaaaaaaaaagagagagagagagagagagagagagagagagaaaaaaaaanamanamanamanamanamanamanamanamanamanamanaaaaaaaaaaaaaaaaaaaaaaaaaaaaaaaaaa
aaaaaaaaaaaaaaaaaaaaaaaaaaaaaaaaaaaaaaaaaoapaoapaoapaoapaoapaoapaoapaoapaoapaaaaaaaaagagagagagagagagagagagagagagagagaaaaaaaaapaoapaoapaoapavawaxapaoapaoapaoapavawaxapaaaaaaaaaaaaaaaaaaaaaaaaaaaaaaaaaa
aaaaaaaaaaaaaaaaaaaaaaaaaaaaaaaaaaaaaaaaamanavawaxanavawaxavawaxamavawaxamanaaaaaaaaagagagagagagagagagagagagagagagagaaaaaaaaanamanamanamanaBaCaDanamanamanamanaBaCaDanaaaaaaaaaaaaaaaaaaaaaaaaaaaaaaaaaa
aaaaaaaaaaaaaaaaaaaaaaaaaaaaaaaaaaaaaaaaaoapaBaCaDapaBaCaDaBaCaDaoaBaCaDaoapaaaaaaaaagagagagagagagagagagagagagagagagaaaaaaaaapaoapaoapaoapaoapaoapaoapaoapaoapaoapaoapaaaaaaaaaaaaaaaaaaaaaaaaaaaaaaaaaa
aaaaaaaaaaaaaaaaaaaaaaaaaaaaaaaaaaaaaaaaamanamanamanamanamanamanamanamanamanaaaaaaaaagagagagagagagagagagagagagagagagaaaaaaaaanamanamanamanamanamanamanamanamanamanamanaaaaaaaaaaaaaaaaaaaaaaaaaaaaaaaaaa
aaaaaaaaaaaaaaaaaaaaaaaaaaaaaaaaaaaaaaaaaoapaoapaoapaoapaoapaoapaoapaoapaoapaaaaaaaaagagagagagagagagagagagagagagagagaaaaaaaaapaoapaoapaoapaoapaoapaoapaoapaoapaoapaoapaaaaaaaaaaaaaaaaaaaaaaaaaaaaaaaaaa
aaaaaaaaaaaaaaaaaaaaaaaaaaaaaaaaaaaaaaaabcbdbcbdbcbdbcbdbcbdbcbdbcbdbcbdbcbdaaaaaaaaagagagagagagagagagagagagagagagagaaaaaaaabdbcbdbcbdbcbdbcbdbcbdbcbdbcbdbcbdbcbdbcbdaaaaaaaaaaaaaaaaaaaaaaaaaaaaaaaaaa
aaaaaaaaaaaaaaaaaaaaaaaaaaaaaaaaaaaaaaaabebebebebebebebebebebebebebebebebebeaaaaaaaaagagagagagagagagagagagagagagagagaaaaaaaabebebebebebebebebebebebebebebebebebebebebeaaaaaaaaaaaaaaaaaaaaaaaaaaaaaaaaaa
"}
