"a" = (/turf/Theme/MaB/Astroman/block1,/area)
"b" = (/turf/Theme/MaB/Astroman/block0,/area)
"c" = (/turf/Theme/MaB/Astroman/bg0,/area)
"d" = (/turf/Theme/MaB/Astroman/bg0,/turf/Theme/MaB/Astroman/spikes/right,/area)
"e" = (/turf/Theme/MaB/Astroman/bg0,/turf/Theme/MaB/Astroman/spikes/left,/area)
"f" = (/turf/Theme/MaB/Astroman/bg0,/turf/Theme/MaB/Astroman/floating0,/area)
"g" = (/turf/Theme/MaB/Astroman/bg0,/turf/Theme/MaB/Astroman/platform2/one,/area)
"h" = (/turf/Theme/MaB/Astroman/bg0,/turf/Theme/MaB/Astroman/platform2/two,/area)
"i" = (/turf/Theme/MaB/Astroman/bg0,/turf/Theme/MaB/Astroman/spikes/top,/area)
"j" = (/turf/Theme/MaB/Astroman/bg0,/turf/Theme/MaB/Astroman/platform4/one,/area)
"k" = (/turf/Theme/MaB/Astroman/bg0,/turf/Theme/MaB/Astroman/platform4/two,/area)
"l" = (/turf/Theme/MaB/Astroman/bg0,/turf/Theme/MaB/Astroman/platform4/three,/area)
"m" = (/turf/Theme/MaB/Astroman/bg0,/turf/Theme/MaB/Astroman/platform4/four,/area)
"n" = (/turf/Theme/MaB/Astroman/bg0,/turf/Theme/MaB/Astroman/platform0/one,/area)
"o" = (/turf/Theme/MaB/Astroman/bg0,/turf/Theme/MaB/Astroman/platform0/two,/area)
"p" = (/turf/Theme/MaB/Astroman/bg0,/turf/Theme/MaB/Astroman/platform0/three,/area)
"q" = (/turf/Theme/MaB/Astroman/bg0,/turf/Theme/MaB/Astroman/platform0/four,/area)
"r" = (/turf/Theme/MaB/Astroman/platform6/three,/area)
"s" = (/turf/Theme/MaB/Astroman/platform6/two,/area)
"t" = (/turf/Theme/MaB/Astroman/platform6/one,/area)
"u" = (/turf/Theme/MaB/Astroman/platform3/one,/area)
"v" = (/turf/Theme/MaB/Astroman/platform3/two,/area)
"w" = (/turf/Theme/MaB/Astroman/platform3/three,/area)
"x" = (/turf/Theme/MaB/Astroman/bg0,/turf/Theme/MaB/Astroman/platform5/two,/area)
"y" = (/turf/Theme/MaB/Astroman/bg0,/turf/Theme/MaB/Astroman/platform5/one,/area)
"z" = (/turf/Theme/MaB/Astroman/bg0,/turf/Theme/MaB/Astroman/platform1/one,/area)
"A" = (/turf/Theme/MaB/Astroman/bg0,/turf/Theme/MaB/Astroman/platform1/two,/area)
"B" = (/turf/Theme/MaB/Astroman/bg0,/turf/Theme/MaB/Astroman/spikes/bottom,/area)

(1,1,1) = {"
aaabbbbbbbbbbbbbbbbbbbbbbbbbbbbbbbbbbbbbbbbbbbbbbbbbbbbbbbbbbbbbbbbbbbbbbbbbbbbbbbbbbbbbbbbbbbbbbbbb
aaabbbbbbbbbbbbbbbbbbbbbbbbbbbbbbbbbbbbbbbbbbbbbbbbbbbbbbbbbbbbbbbbbbbbbbbbbbbbbbbbbbbbbbbbbbbbbbbbb
aaabbbbbbbbbbbbbbbbbbbbbbbbbbbbbbbbbbbbbbbbbbbbbbbbbbbbbbbbbbbbbbbbbbbbbbbbbbbbbbbbbbbbbbbbbbbbbbbbb
aaaccccccccccccabdcccccccccccccccebaccccccccccccaaaaccccccccccccabdcccccccccccccccebaccccccccccccaaa
aaaccccccccccccbadccccccccccccccceabccccccccccccaaaaccccccccccccbadccccccccccccccceabccccccccccccaaa
aaaccccccccccccabdcccccccccccccccebaccccccccccccaaaaccccccccccccabdcccccccccccccccebaccccccccccccaaa
aaaccccccccccccbadccccccccccccccceabccccccccccccaaaaccccccccccccbadccccccccccccccceabccccccccccccaaa
aaaccccccccccccabdcccccccccccccccebaccccccccccccaaaaccccccccccccabdcccccccccccccccebaccccccccccccaaa
aaaccccccccccccbadccccccccccccccceabccccccccccccaaaaccccccccccccbadccccccccccccccceabccccccccccccaaa
aaafffffffcccccccccccccghcghcccccccccccccfffffffaaaafffffffcccccccccccccghcghcccccccccccccfffffffaaa
aaaiiiiiiiffcccccccccccccccccccccccccccffiiiiiiiaaaaiiiiiiiffcccccccccccccccccccccccccccffiiiiiiiaaa
aaaccccccccccccccccffffcccccffffccccccccccccccccaaaaccccccccccccccccffffcccccffffccccccccccccccccaaa
aaacccccccccccccccccccccccccccccccccccccccccccccaaaacccccccccccccccccccccccccccccccccccccccccccccaaa
aaaccccccccccfcccccccccccccccccccccccfccccccccccaaaaccccccccccfcccccccccccccccccccccccfccccccccccaaa
aaacccccccccccccccccccccccccccccccccccccccccccccaaaacccccccccccccccccccccccccccccccccccccccccccccaaa
aaaccccccccccccffffcccccccccccccffffccccccccccccaaaaccccccccccccffffcccccccccccccffffccccccccccccaaa
aaacccccccccccccccccccccccccccccccccccccccccccccaaaacccccccccccccccccccccccccccccccccccccccccccccaaa
aaacccccccccccccccccccccccccccccccccccccccccccccaaaacccccccccccccccccccccccccccccccccccccccccccccaaa
aaacccccccccccccccccccccccccccccccccccccccccccccaaaacccccccccccccccccccccccccccccccccccccccccccccaaa
aaacccccccccccccccccccghcccghcccccccccccccccccccaaaacccccccccccccccccccghcccghcccccccccccccccccccaaa
aaajklmnopqjklmnopqcccccccccccccjklmnopqjklmnopqaaaajklmnopqjklmnopqcccccccccccccjklmnopqjklmnopqaaa
aaaiiiiiiiiiiiiiiiiccccccccccccciiiiiiiiiiiiiiiiaaaaiiiiiiiiiiiiiiiiccccccccccccciiiiiiiiiiiiiiiiaaa
aaacccccccccccccccccccccccccccccccccccccccccccccaaaacccccccccccccccccccccccccccccccccccccccccccccaaa
aaacccccccccccccccccccccccccccccccccccccccccccccaaaacccccccccccccccccccccccccccccccccccccccccccccaaa
aaacccccccccccccccccccccccccccccccccccccccccccccaaaacccccccccccccccccccccccccccccccccccccccccccccaaa
aaaccccccccccccccccghcccccccccghccccccccccccccccaaaaccccccccccccccccghcccccccccghccccccccccccccccaaa
aaacccccccccccccccccccccccccccccccccccccccccccccaaaacccccccccccccccccccccccccccccccccccccccccccccaaa
aaacccccccccccccccccccccccccccccccccccccccccccccaaaacccccccccccccccccccccccccccccccccccccccccccccaaa
aaacccccccccccccccccccccccccccccccccccccccccccccaaaacccccccccccccccccccccccccccccccccccccccccccccaaa
aaacccccccccccccccccccghcccghcccccccccccccccccccaaaacccccccccccccccccccghcccghcccccccccccccccccccaaa
aaaccccccccccccccccccciiccciicccccccccccccccccccaaaaccccccccccccccccccciiccciicccccccccccccccccccaaa
aaacccccccccccccccccccccccccccccccccccccccccccccaaaacccccccccccccccccccccccccccccccccccccccccccccaaa
aaacccccccccccccccccccccccccccccccccccccccccccccaaaacccccccccccccccccccccccccccccccccccccccccccccaaa
aaarsrsrsrsrsrstcccccccccccccccccccuvwvwvwvwvwvwaaaarsrsrsrsrsrstcccccccccccccccccccuvwvwvwvwvwvwaaa
aaadccccccccccccccccghcccccccghcccccccccccccccceaaaadccccccccccccccccghcccccccghcccccccccccccccceaaa
aaadccccccccccccccccccccccccccccccccccccccccccceaaaadccccccccccccccccccccccccccccccccccccccccccceaaa
aaadccccccccccccccccccccccccccccccccccccccccccceaaaadccccccccccccccccccccccccccccccccccccccccccceaaa
aaadccccccccccccccghcccccccccccghcccccccccccccceaaaadccccccccccccccghcccccccccccghcccccccccccccceaaa
aaadcccccccccccccciiccccccccccciicccccccccccccceaaaadcccccccccccccciiccccccccccciicccccccccccccceaaa
aaadccccccccccccccccccccccccccccccccccccccccccceaaaadccccccccccccccccccccccccccccccccccccccccccceaaa
aaadccccccccccccccccccccghccccccccccccccccccccceaaaadccccccccccccccccccccghccccccccccccccccccccceaaa
aaaxxxxxxxxxxxxxxxyccccccccccccczAAAAAAAAAAAAAAAaaaaxxxxxxxxxxxxxxxyccccccccccccczAAAAAAAAAAAAAAAaaa
aaaiiiiiiiiiiiiiiiiccccccccccccciiiiiiiiiiiiiiiiaaaaiiiiiiiiiiiiiiiiccccccccccccciiiiiiiiiiiiiiiiaaa
aaacccccccccccccccccccccccccccccccccccccccccccccaaaacccccccccccccccccccccccccccccccccccccccccccccaaa
aaacccccccccccccccccccccccccccccccccccccccccccccaaaacccccccccccccccccccccccccccccccccccccccccccccaaa
aaacccccccccccccccccccccccccccccccccccccccccccccaaaacccccccccccccccccccccccccccccccccccccccccccccaaa
aaacccccccccccccccccccccccccccccccccccccccccccccaaaacccccccccccccccccccccccccccccccccccccccccccccaaa
aaaBBBBBBBBBBBBBBBBBBBBBBBBBBBBBBBBBBBBBBBBBBBBBaaaaBBBBBBBBBBBBBBBBBBBBBBBBBBBBBBBBBBBBBBBBBBBBBaaa
aaabbbbbbbbbbbbbbbbbbbbbbbbbbbbbbbbbbbbbbbbbbbbbaaaabbbbbbbbbbbbbbbbbbbbbbbbbbbbbbbbbbbbbbbbbbbbbaaa
aaabbbbbbbbbbbbbbbbbbbbbbbbbbbbbbbbbbbbbbbbbbbbbaaaabbbbbbbbbbbbbbbbbbbbbbbbbbbbbbbbbbbbbbbbbbbbbaaa
aaabbbbbbbbbbbbbbbbbbbbbbbbbbbbbbbbbbbbbbbbbbbbbaaaabbbbbbbbbbbbbbbbbbbbbbbbbbbbbbbbbbbbbbbbbbbbbaaa
aaabbbbbbbbbbbbbbbbbbbbbbbbbbbbbbbbbbbbbbbbbbbbbaaaabbbbbbbbbbbbbbbbbbbbbbbbbbbbbbbbbbbbbbbbbbbbbaaa
aaaccccccccccccabdcccccccccccccccebaccccccccccccaaaaccccccccccccabdcccccccccccccccebaccccccccccccaaa
aaaccccccccccccbadccccccccccccccceabccccccccccccaaaaccccccccccccbadccccccccccccccceabccccccccccccaaa
aaaccccccccccccabdcccccccccccccccebaccccccccccccaaaaccccccccccccabdcccccccccccccccebaccccccccccccaaa
aaaccccccccccccbadccccccccccccccceabccccccccccccaaaaccccccccccccbadccccccccccccccceabccccccccccccaaa
aaaccccccccccccabdcccccccccccccccebaccccccccccccaaaaccccccccccccabdcccccccccccccccebaccccccccccccaaa
aaaccccccccccccbadccccccccccccccceabccccccccccccaaaaccccccccccccbadccccccccccccccceabccccccccccccaaa
aaafffffffcccccccccccccghcghcccccccccccccfffffffaaaafffffffcccccccccccccghcghcccccccccccccfffffffaaa
aaaiiiiiiiffcccccccccccccccccccccccccccffiiiiiiiaaaaiiiiiiiffcccccccccccccccccccccccccccffiiiiiiiaaa
aaaccccccccccccccccffffcccccffffccccccccccccccccaaaaccccccccccccccccffffcccccffffccccccccccccccccaaa
aaacccccccccccccccccccccccccccccccccccccccccccccaaaacccccccccccccccccccccccccccccccccccccccccccccaaa
aaaccccccccccfcccccccccccccccccccccccfccccccccccaaaaccccccccccfcccccccccccccccccccccccfccccccccccaaa
aaacccccccccccccccccccccccccccccccccccccccccccccaaaacccccccccccccccccccccccccccccccccccccccccccccaaa
aaaccccccccccccffffcccccccccccccffffccccccccccccaaaaccccccccccccffffcccccccccccccffffccccccccccccaaa
aaacccccccccccccccccccccccccccccccccccccccccccccaaaacccccccccccccccccccccccccccccccccccccccccccccaaa
aaacccccccccccccccccccccccccccccccccccccccccccccaaaacccccccccccccccccccccccccccccccccccccccccccccaaa
aaacccccccccccccccccccccccccccccccccccccccccccccaaaacccccccccccccccccccccccccccccccccccccccccccccaaa
aaacccccccccccccccccccghcccghcccccccccccccccccccaaaacccccccccccccccccccghcccghcccccccccccccccccccaaa
aaajklmnopqjklmnopqcccccccccccccjklmnopqjklmnopqaaaajklmnopqjklmnopqcccccccccccccjklmnopqjklmnopqaaa
aaaiiiiiiiiiiiiiiiiccccccccccccciiiiiiiiiiiiiiiiaaaaiiiiiiiiiiiiiiiiccccccccccccciiiiiiiiiiiiiiiiaaa
aaacccccccccccccccccccccccccccccccccccccccccccccaaaacccccccccccccccccccccccccccccccccccccccccccccaaa
aaacccccccccccccccccccccccccccccccccccccccccccccaaaacccccccccccccccccccccccccccccccccccccccccccccaaa
aaacccccccccccccccccccccccccccccccccccccccccccccaaaacccccccccccccccccccccccccccccccccccccccccccccaaa
aaaccccccccccccccccghcccccccccghccccccccccccccccaaaaccccccccccccccccghcccccccccghccccccccccccccccaaa
aaacccccccccccccccccccccccccccccccccccccccccccccaaaacccccccccccccccccccccccccccccccccccccccccccccaaa
aaacccccccccccccccccccccccccccccccccccccccccccccaaaacccccccccccccccccccccccccccccccccccccccccccccaaa
aaacccccccccccccccccccccccccccccccccccccccccccccaaaacccccccccccccccccccccccccccccccccccccccccccccaaa
aaacccccccccccccccccccghcccghcccccccccccccccccccaaaacccccccccccccccccccghcccghcccccccccccccccccccaaa
aaaccccccccccccccccccciiccciicccccccccccccccccccaaaaccccccccccccccccccciiccciicccccccccccccccccccaaa
aaacccccccccccccccccccccccccccccccccccccccccccccaaaacccccccccccccccccccccccccccccccccccccccccccccaaa
aaacccccccccccccccccccccccccccccccccccccccccccccaaaacccccccccccccccccccccccccccccccccccccccccccccaaa
aaarsrsrsrsrsrstcccccccccccccccccccuvwvwvwvwvwvwaaaarsrsrsrsrsrstcccccccccccccccccccuvwvwvwvwvwvwaaa
aaadccccccccccccccccghcccccccghcccccccccccccccceaaaadccccccccccccccccghcccccccghcccccccccccccccceaaa
aaadccccccccccccccccccccccccccccccccccccccccccceaaaadccccccccccccccccccccccccccccccccccccccccccceaaa
aaadccccccccccccccccccccccccccccccccccccccccccceaaaadccccccccccccccccccccccccccccccccccccccccccceaaa
aaadccccccccccccccghcccccccccccghcccccccccccccceaaaadccccccccccccccghcccccccccccghcccccccccccccceaaa
aaadcccccccccccccciiccccccccccciicccccccccccccceaaaadcccccccccccccciiccccccccccciicccccccccccccceaaa
aaadccccccccccccccccccccccccccccccccccccccccccceaaaadccccccccccccccccccccccccccccccccccccccccccceaaa
aaadccccccccccccccccccccghccccccccccccccccccccceaaaadccccccccccccccccccccghccccccccccccccccccccceaaa
aaaxxxxxxxxxxxxxxxyccccccccccccczAAAAAAAAAAAAAAAaaaaxxxxxxxxxxxxxxxyccccccccccccczAAAAAAAAAAAAAAAaaa
aaaiiiiiiiiiiiiiiiiccccccccccccciiiiiiiiiiiiiiiiaaaaiiiiiiiiiiiiiiiiccccccccccccciiiiiiiiiiiiiiiiaaa
aaacccccccccccccccccccccccccccccccccccccccccccccaaaacccccccccccccccccccccccccccccccccccccccccccccaaa
aaacccccccccccccccccccccccccccccccccccccccccccccaaaacccccccccccccccccccccccccccccccccccccccccccccaaa
aaacccccccccccccccccccccccccccccccccccccccccccccaaaacccccccccccccccccccccccccccccccccccccccccccccaaa
aaacccccccccccccccccccccccccccccccccccccccccccccaaaacccccccccccccccccccccccccccccccccccccccccccccaaa
aaaBBBBBBBBBBBBBBBBBBBBBBBBBBBBBBBBBBBBBBBBBBBBBaaaaBBBBBBBBBBBBBBBBBBBBBBBBBBBBBBBBBBBBBBBBBBBBBaaa
bbbbbbbbbbbbbbbbbbbbbbbbbbbbbbbbbbbbbbbbbbbbbbbbbbbbbbbbbbbbbbbbbbbbbbbbbbbbbbbbbbbbbbbbbbbbbbbbbaaa
bbbbbbbbbbbbbbbbbbbbbbbbbbbbbbbbbbbbbbbbbbbbbbbbbbbbbbbbbbbbbbbbbbbbbbbbbbbbbbbbbbbbbbbbbbbbbbbbbaaa
bbbbbbbbbbbbbbbbbbbbbbbbbbbbbbbbbbbbbbbbbbbbbbbbbbbbbbbbbbbbbbbbbbbbbbbbbbbbbbbbbbbbbbbbbbbbbbbbbaaa
"}
