"aa" = (/turf/Theme/MaB/Burnerman/block0/one,/area)
"ab" = (/turf/Theme/MaB/Burnerman/block0/two,/area)
"ac" = (/turf/Theme/MaB/Burnerman/block0/three,/area)
"ad" = (/turf/Theme/MaB/Burnerman/block0/four,/area)
"ae" = (/turf/Theme/MaB/Burnerman/wall0/three,/area)
"af" = (/turf/Theme/MaB/Burnerman/bg0,/area)
"ag" = (/turf/Theme/MaB/Burnerman/wall0/two,/area)
"ah" = (/turf/Theme/MaB/Burnerman/bg0,/turf/Theme/MaB/Burnerman/floating1,/area)
"ai" = (/turf/Theme/MaB/Burnerman/bg0,/turf/Theme/MaB/Burnerman/floating0/one,/area)
"aj" = (/turf/Theme/MaB/Burnerman/bg0,/turf/Theme/MaB/Burnerman/floating0/two,/area)
"ak" = (/turf/Theme/MaB/Burnerman/block1/one,/area)
"al" = (/turf/Theme/MaB/Burnerman/block1/two,/area)
"am" = (/turf/Theme/MaB/Burnerman/block1/three,/area)
"an" = (/turf/Theme/MaB/Burnerman/block1/four,/area)
"ao" = (/turf/Theme/MaB/Burnerman/block1/five,/area)
"ap" = (/turf/Theme/MaB/Burnerman/block1/six,/area)
"aq" = (/turf/Theme/MaB/Burnerman/block1/seven,/area)
"ar" = (/turf/Theme/MaB/Burnerman/block1/eight,/area)
"as" = (/turf/Theme/MaB/Burnerman/block1/nine,/area)
"at" = (/turf/Theme/MaB/Burnerman/pillar0/one,/area)
"au" = (/turf/Theme/MaB/Burnerman/bg0,/turf/Theme/MaB/Burnerman/ground0/layer,/area)
"av" = (/turf/Theme/MaB/Burnerman/pillar0/two,/area)
"aw" = (/turf/Theme/MaB/Burnerman/ground0/one,/area)
"ax" = (/obj/Teleporter/Left/ttl,/turf/Theme/MaB/Burnerman/bg0,/area)
"ay" = (/obj/Teleporter/Left/ttm,/turf/Theme/MaB/Burnerman/bg0,/area)
"az" = (/obj/Teleporter/Left/ttr,/turf/Theme/MaB/Burnerman/bg0,/area)
"aA" = (/obj/Teleporter/Right/ttr,/turf/Theme/MaB/Burnerman/bg0,/area)
"aB" = (/obj/Teleporter/Right/ttm,/turf/Theme/MaB/Burnerman/bg0,/area)
"aC" = (/obj/Teleporter/Right/ttl,/turf/Theme/MaB/Burnerman/bg0,/area)
"aD" = (/obj/Teleporter/Left/tl,/turf/Theme/MaB/Burnerman/bg0,/area)
"aE" = (/obj/Teleporter/Left/tm,/turf/Theme/MaB/Burnerman/bg0,/area)
"aF" = (/obj/Teleporter/Left/tr,/turf/Theme/MaB/Burnerman/bg0,/area)
"aG" = (/obj/Teleporter/Right/tr,/turf/Theme/MaB/Burnerman/bg0,/area)
"aH" = (/obj/Teleporter/Right/tm,/turf/Theme/MaB/Burnerman/bg0,/area)
"aI" = (/obj/Teleporter/Right/tl,/turf/Theme/MaB/Burnerman/bg0,/area)
"aJ" = (/obj/Teleporter/Left/ml,/turf/Theme/MaB/Burnerman/bg0,/area)
"aK" = (/obj/Teleporter/Left/mm,/turf/Theme/MaB/Burnerman/bg0,/area)
"aL" = (/obj/Teleporter/Left/mr,/turf/Theme/MaB/Burnerman/bg0,/area)
"aM" = (/obj/Teleporter/Right/mr,/turf/Theme/MaB/Burnerman/bg0,/area)
"aN" = (/obj/Teleporter/Right/mm,/turf/Theme/MaB/Burnerman/bg0,/area)
"aO" = (/obj/Teleporter/Right/ml,/turf/Theme/MaB/Burnerman/bg0,/area)
"aP" = (/turf/Theme/MaB/Burnerman/bg0,/obj/Teleporter/Left/bl,/turf/Theme/MaB/Burnerman/ground0/layer,/area)
"aQ" = (/turf/Theme/MaB/Burnerman/bg0,/obj/Teleporter/Left/bm,/turf/Theme/MaB/Burnerman/ground0/layer,/area)
"aR" = (/turf/Theme/MaB/Burnerman/bg0,/obj/Teleporter/Left/br,/turf/Theme/MaB/Burnerman/ground0/layer,/area)
"aS" = (/turf/Theme/MaB/Burnerman/bg0,/obj/Teleporter/Right/br,/turf/Theme/MaB/Burnerman/ground0/layer,/area)
"aT" = (/turf/Theme/MaB/Burnerman/bg0,/obj/Teleporter/Right/bm,/turf/Theme/MaB/Burnerman/ground0/layer,/area)
"aU" = (/turf/Theme/MaB/Burnerman/bg0,/obj/Teleporter/Right/bl,/turf/Theme/MaB/Burnerman/ground0/layer,/area)
"aV" = (/turf/Theme/MaB/Burnerman/wall0/one,/area)
"aW" = (/obj/Teleporter/Right/br,/turf/Theme/MaB/Burnerman/bg0,/area)
"aX" = (/obj/Teleporter/Right/bl,/turf/Theme/MaB/Burnerman/bg0,/area)
"aY" = (/turf/Theme/MaB/Burnerman/wall0/four,/area)
"aZ" = (/obj/Teleporter/Left/bl,/turf/Theme/MaB/Burnerman/bg0,/area)
"ba" = (/obj/Teleporter/Left/br,/turf/Theme/MaB/Burnerman/bg0,/area)
"bb" = (/turf/Theme/MaB/Burnerman/ground1/one,/area)
"bc" = (/turf/Theme/MaB/Burnerman/ground1/two,/area)
"bd" = (/turf/Theme/MaB/Burnerman/ground1/three,/area)
"be" = (/turf/Theme/MaB/Burnerman/ground1/four,/area)
"bf" = (/turf/Theme/MaB/Burnerman/ground1/five,/area)
"bg" = (/turf/Theme/MaB/Burnerman/ground1/six,/area)
"bh" = (/turf/Theme/MaB/Burnerman/ground1/seven,/area)
"bi" = (/turf/Theme/MaB/Burnerman/ground1/eight,/area)
"bj" = (/turf/Theme/MaB/Burnerman/ground1/nine,/area)

(1,1,1) = {"
aaabaaabaaabaaabaaabaaabaaabaaabaaabaaabaaabaaabaaabaaabaaabaaabaaabaaabaaabaaabaaabaaabaaabaaabaaabaaabaaabaaabaaabaaabaaabaaabaaabaaabaaabaaabaaabaaabaaabaaabaaabaaabaaabaaabaaabaaabaaabaaabaaabaaab
acadacadacadacadacadacadacadacadacadacadacadacadacadacadacadacadacadacadacadacadacadacadacadacadacadacadacadacadacadacadacadacadacadacadacadacadacadacadacadacadacadacadacadacadacadacadacadacadacadacad
aaabaaabaaabaaabaaabaaabaaabaaabaaabaaabaaabaaabaaabaaabaaabaaabaaabaaabaaabaaabaaabaaabaaabaaabaaabaaabaaabaaabaaabaaabaaabaaabaaabaaabaaabaaabaaabaaabaaabaaabaaabaaabaaabaaabaaabaaabaaabaaabaaabaaab
acadacadacadacadacadacadacadacadacadacadacadacadacadacadacadacadacadacadacadacadacadacadacadacadacadacadacadacadacadacadacadacadacadacadacadacadacadacadacadacadacadacadacadacadacadacadacadacadacadacad
aaabaaabaaabaaabaaabaaabaaabaaabaaabaaabaaabaaabaaabaaabaaabaaabaaabaaabaaabaaabaaabaaabaaabaaabaaabaaabaaabaaabaaabaaabaaabaaabaaabaaabaaabaaabaaabaaabaaabaaabaaabaaabaaabaaabaaabaaabaaabaaabaaabaaab
acadacadacadacadacadacadacadacadacadacadacadacadacadacadacadacadacadacadacadacadacadacadacadacadacadacadacadacadacadacadacadacadacadacadacadacadacadacadacadacadacadacadacadacadacadacadacadacadacadacad
aaabaaabaaabaaabaaabaaabaaabaaabaaabaeaeafafafafafafafafafafafafafafafafafafafafafafafafafafafafafafafafafafafafafafafafafafafafafafafafafafafafafafafafafafafafaeaeaaabaaabaaabaaabaaabaaabaaabaaabaaab
acadacadacadacadacadacadacadacadacadagagafafafafafafafafafafafafafafafafafafafafafafafafafafafafafafafafafafafafafafafafafafafafafafafafafafafafafafafafafafafafagagacadacadacadacadacadacadacadacadacad
aaabaaabaaabaaabaaabaaabaaabaaabaaabaeaeafafafafafafafafafafafafafafafafafafafafafafafafafafafafafafafafafafafafafafafafafafafafafafafafafafafafafafafafafafafafaeaeaaabaaabaaabaaabaaabaaabaaabaaabaaab
acadacadacadacadacadacadacadacadacadagagafafafafafafafafafafafafafafafafafafafafafafafafafafafafafafafafafafafafafafafafafafafafafafafafafafafafafafafafafafafafagagacadacadacadacadacadacadacadacadacad
aaabaaabaaabaaabaaabaaabaaabaaabaaabaeaeafafafafafafafafafafafafafafafafafafafafafafafafafafafafafafafafafafafafafafafafafafafafafafafafafafafafafafafafafafafafaeaeaaabaaabaaabaaabaaabaaabaaabaaabaaab
acadacadacadacadacadacadacadacadacadagagafafafafafafafafafafafafafafafafafafafafafafafafafafafafafafafafafafafafafafafafafafafafafafafafafafafafafafafafafafafafagagacadacadacadacadacadacadacadacadacad
aaabaaabaaabaaabaaabaaabaaabaaabaaabaeaeafafafafafafafafafafafafafafahaiajahafafafafafafafafafafaaabaaabafafafafafafafafafafahaiajahafafafafafafafafafafafafafafaeaeaaabaaabaaabaaabaaabaaabaaabaaabaaab
acadacadacadacadacadacadacadacadacadagagafafafafafafafafafafafafafafafafafafafafafafafafafafafafacadacadafafafafafafafafafafafafafafafafafafafafafafafafafafafafagagacadacadacadacadacadacadacadacadacad
aaabaaabaaabaaabaaabaaabaaabaaabaaabaeaeafafafafafafafafafafafahafafafafafafafafafafafafafafafafafafafafafafafafafafafafafafafafafafafafahafafafafafafafafafafafaeaeaaabaaabaaabaaabaaabaaabaaabaaabaaab
acadacadacadacadacadacadacadacadacadagagafafafafafafafafafafafafafafafafafafafaiajaiajafafafafafafafafafafafafafafaiajaiajafafafafafafafafafafafafafafafafafafafagagacadacadacadacadacadacadacadacadacad
aaabaaabaaabaaabaaabaaabaaabaaabaaabaeaeakalamakalamakalamafafafafafafafafafafafafafafafafafafafafafafafafafafafafafafafafafafafafafafafafafafakalamakalamakalamaeaeaaabaaabaaabaaabaaabaaabaaabaaabaaab
acadacadacadacadacadacadacadacadacadagaganaoapanaoapanaoapafafafafafafafafafafafafafafafafafafafafafafafafafafafafafafafafafafafafafafafafafafanaoapanaoapanaoapagagacadacadacadacadacadacadacadacadacad
aaabaaabaaabaaabaaabaaabaaabaaabaaabaeaeaqarasaqarasaqarasafafafafafafafafafafafafafafafafafafaiajaiajaiajafafafafafafafafafafafafafafafafafafaqarasaqarasaqarasaeaeaaabaaabaaabaaabaaabaaabaaabaaabaaab
acadacadacadacadacadacadacadacadacadagagakalamakalamakalamakalamafafafafafafafafafafafafafafafafafafafafafafafafafafafafafafafafafafafafakalamakalamakalamakalamagagacadacadacadacadacadacadacadacadacad
aaabaaabaaabaaabaaabaaabaaabaaabaaabaeaeanaoapanaoapanaoapanaoapafafafafafafafafafafafaiajaiajafafafafafafaiajaiajafafafafafafafafafafafanaoapanaoapanaoapanaoapaeaeaaabaaabaaabaaabaaabaaabaaabaaabaaab
acadacadacadacadacadacadacadacadacadagagaqarasaqarasaqarasaqarasafafafafafafafafafafafafafafafafafafafafafafafafafafafafafafafafafafafafaqarasaqarasaqarasaqarasagagacadacadacadacadacadacadacadacadacad
aaabaaabaaabaaabaaabaaabaaabaaabaaabaeaeakalamakalamakalamakalamakalamafafafahaiajahafafafafafafafafafafafafafafafafahaiajahafafafakalamakalamakalamakalamakalamaeaeaaabaaabaaabaaabaaabaaabaaabaaabaaab
acadacadacadacadacadacadacadacadacadagaganaoapanaoapanaoapanaoapanaoapafafafafafafafafafafafafafafafafafafafafafafafafafafafafafafanaoapanaoapanaoapanaoapanaoapagagacadacadacadacadacadacadacadacadacad
aaabaaabaaabaaabaaabaaabaaabaaabaaabaeaeaqarasaqarasaqarasaqarasaqarasafafafafafafafafafafafafafafafafafafafafafafafafafafafafafafaqarasaqarasaqarasaqarasaqarasaeaeaaabaaabaaabaaabaaabaaabaaabaaabaaab
acadacadacadacadacadacadacadacadacadagagafafafafafafafafafafafafafafafafafafafafafafafafafafafafafafafafafafafafafafafafafafafafafafafafafafafafafafafafafafafafagagacadacadacadacadacadacadacadacadacad
aaabaaabaaabaaabaaabaaabaaabaaabaaabaeaeafafafafafafafafafafafafafafafafafafafafafafafafafafafafafafafafafafafafafafafafafafafafafafafafafafafafafafafafafafafafaeaeaaabaaabaaabaaabaaabaaabaaabaaabaaab
acadacadacadacadacadacadacadacadacadagagafafafafafafafafafafafafafafafafafafafafafafafafafafafafafafafafafafafafafafafafafafafafafafafafafafafafafafafafafafafafagagacadacadacadacadacadacadacadacadacad
aaabaaabaaabaaabaaabaaabaaabaaabaaabaeaeafafafafafafafafafafafafafafafafafafafafafafafafafafafafafafafafafafafafafafafafafafafafafafafafafafafafafafafafafafafafaeaeaaabaaabaaabaaabaaabaaabaaabaaabaaab
acadacadacadacadacadacadacadacadacadagagafafafafafafafafafafafafafafafafafafafafafafafafafafafafafafafafafafafafafafafafafafafafafafafafafafafafafafafafafafafafagagacadacadacadacadacadacadacadacadacad
aaabaaabaaabaaabaaabaaabaaabaaabaaabaeaeafafafafafafafafafafafafafafafafafafafafafafafafafafafafafafafafafafafafafafafafafafafafafafafafafafafafafafafafafafafafaeaeaaabaaabaaabaaabaaabaaabaaabaaabaaab
acadacadacadacadacadacadacadacadacadagagafafafafafafafafafafafafakalamakalamakalamakalamakalamahafafafafahakalamakalamakalamakalamakalamafafafafafafafafafafafafagagacadacadacadacadacadacadacadacadacad
aaabaaabaaabaaabaaabaaabaaabaaabaaabaeaeafafafafafafafafafafafafanaoapanaoapanaoapanaoapanaoapafafafafafafanaoapanaoapanaoapanaoapanaoapafafafafafafafafafafafafaeaeaaabaaabaaabaaabaaabaaabaaabaaabaaab
acadacadacadacadacadacadacadacadacadagagafafafafafafafafafafafafaqarasaqarasaqarasaqarasaqarasafafafafafafaqarasaqarasaqarasaqarasaqarasafafafafafafafafafafafafagagacadacadacadacadacadacadacadacadacad
aaabaaabaaabaaabaaabaaabaaabaaabaaabaeaeafafafafafafafafafaiajafafafafafafafafafafafafafafafafafafafafafafafafafafafafafafafafafafafafafafafafafafafafafafafafafaeaeaaabaaabaaabaaabaaabaaabaaabaaabaaab
acadacadacadacadacadacadacadacadacadagagafafafafafafafafafafafafafafafafafafafafafafafafafafafafafafafafafafafafafafafafafafafafafafafafafaiajafafafafafafafafafagagacadacadacadacadacadacadacadacadacad
aaabaaabaaabaaabaaabaaabaaabaaabaaabaeaeafafaiajafafaiajafafafafafafafafafafafafafafafafafafafafafafafafafafafafafafafafafafafafafafafafafafafafaiajafafaiajafafaeaeaaabaaabaaabaaabaaabaaabaaabaaabaaab
acadacadacadacadacadacadacadacadacadagagafafafafafafafafafafafafafafafafafafafafafafafafafafafafahafafahafafafafafafafafafafafafafafafafafafafafafafafafafafafafagagacadacadacadacadacadacadacadacadacad
aaabaaabaaabaaabaaabaaabaaabaaabaaabaeaeafafafafafafafafafafafafafafafafafafafafafafafafafafafafafafafafafafafafafafafafafafafafafafafafafafafafafafafafafafafafaeaeaaabaaabaaabaaabaaabaaabaaabaaabaaab
acadacadacadacadacadacadacadacadacadagagafafafafafafafafafafafafafafafafafafafafafafafafafafafafafafafafafafafafafafafafafafafafafafafafafafafafafafafafafafafafagagacadacadacadacadacadacadacadacadacad
aaabaaabaaabaaabaaabaaabaaabaaabaaabaeaeafafafafafafafafafafafafafafafafafafafafafafafafafahafafafafafafafafahafafafafafafafafafafafafafafafafafafafafafafafafafaeaeaaabaaabaaabaaabaaabaaabaaabaaabaaab
acadacadacadacadacadacadacadacadacadagagafafafafafafafafafafafafafafafafafafafafafafafafafafafafafafafafafafafafafafafafafafafafafafafafafafafafafafafafafafafafagagacadacadacadacadacadacadacadacadacad
aaabaaabaaabaaabaaabaaabaaabaaabaaabaeaeafafafafafafafafafafafafafafafafafafafahafafahafafafafafafafafafafafafafafahafafahafafafafafafafafafafafafafafafafafafafaeaeaaabaaabaaabaaabaaabaaabaaabaaabaaab
acadacadacadacadacadacadacadacadacadagagafafafafafafafafafafafafafahafafahafafafafafafafafafafafafafafafafafafafafafafafafafafahafafahafafafafafafafafafafafafafagagacadacadacadacadacadacadacadacadacad
aaabaaabaaabaaabaaabaaabaaabaaabaaabaeaeafafafafafafafafafafafafafafafafafafafafafafafafafafafafafafafafafafafafafafafafafafafafafafafafafafafafafafafafafafafafaeaeaaabaaabaaabaaabaaabaaabaaabaaabaaab
acadacadacadacadacadacadacadacadacadagagafafafafafafafahafafahafafafafafafafafafafafafafafafafafaiajaiajafafafafafafafafafafafafafafafafafahafafahafafafafafafafagagacadacadacadacadacadacadacadacadacad
aaabaaabaaabaaabaaabaaabaaabaaabaaabaeaeatauauauafafafafafafafafafafafafafafafafafafafafafafafafafafafafafafafafafafafafafafafafafafafafafafafafafafafafauauauataeaeaaabaaabaaabaaabaaabaaabaaabaaabaaab
acadacadacadacadacadacadacadacadacadagagavawawawafafafafafafafafafafafafafafafafafafafafahafafafafafafafafafafahafafafafafafafafafafafafafafafafafafafafawawawavagagacadacadacadacadacadacadacadacadacad
aaabaaabaaabaaabaaabaaabaaabaaabaaabaeaeaaabaaabafafafafafafafafafafafafafafafafafafafafafafafafafafafafafafafafafafafafafafafafafafafafafafafafafafafafaaabaaabaeaeaaabaaabaaabaaabaaabaaabaaabaaabaaab
acadacadacadacadacadacadacadacadacadagagacadacadafafafafafafafafafafafafafafafaiajafafafafafafafafafafafafafafafafafafaiajafafafafafafafafafafafafafafafacadacadagagacadacadacadacadacadacadacadacadacad
aaabaaabaaabaaabaaabaaabaaabaaabaaabaeaeaaabaaabatauauauafafafafafafafafafafafafafafafafafafafafafafafafafafafafafafafafafafafafafafafafafafafafauauauataaabaaabaeaeaaabaaabaaabaaabaaabaaabaaabaaabaaab
acadacadacadacadacadacadacadacadacadagagacadacadavawawawafafafafafaiajafafafafafafafafafafafafafafafafafafafafafafafafafafafafafafaiajafafafafafawawawavacadacadagagacadacadacadacadacadacadacadacadacad
aaabaaabaaabaaabaaabaaabaaabaaabaaabaeaeaaabaaabaaabaaabafafafafafafafafafafafafafafafafafafafafafafafafafafafafafafafafafafafafafafafafafafafafaaabaaabaaabaaabaeaeaaabaaabaaabaaabaaabaaabaaabaaabaaab
acadacadacadacadacadacadacadacadacadagagacadacadacadacadafafafafafafafafafafafafafafafafafafafafafafafafafafafafafafafafafafafafafafafafafafafafacadacadacadacadagagacadacadacadacadacadacadacadacadacad
aaabaaabaaabaaabaaabaaabaaabaaabaaabaeaeaaabaaabaaabaaabatauauauafafafafafafafafafafafafafafafafafafafafafafafafafafafafafafafafafafafafauauauataaabaaabaaabaaabaeaeaaabaaabaaabaaabaaabaaabaaabaaabaaab
acadacadacadacadacadacadacadacadacadagagacadacadacadacadavawawawafafafafafafafafafafafafafafaxayazafafaAaBaCafafafafafafafafafafafafafafawawawavacadacadacadacadagagacadacadacadacadacadacadacadacadacad
aaabaaabaaabaaabaaabaaabaaabaaabaaabaeaeaaabaaabaaabaaabaaabaaabafafafafafafafafafafafafafafaDaEaFafafaGaHaIafafafafafafafafafafafafafafaaabaaabaaabaaabaaabaaabaeaeaaabaaabaaabaaabaaabaaabaaabaaabaaab
acadacadacadacadacadacadacadacadacadagagacadacadacadacadacadacadafafafafafafafafafafafafafafaJaKaLafafaMaNaOafafafafafafafafafafafafafafacadacadacadacadacadacadagagacadacadacadacadacadacadacadacadacad
aaabaaabaaabaaabaaabaaabaaabaaabaaabaeaeaaabaaabaaabaaabaaabaaabatauauauauauauauauauauauauauaPaQaRatataSaTaUauauauauauauauauauauauauauataaabaaabaaabaaabaaabaaabaeaeaaabaaabaaabaaabaaabaaabaaabaaabaaab
acadacadacadacadacadacadacadacadacadagagacadacadacadacadacadacadavawawawawawawawawawawawawawawawawavavawawawawawawawawawawawawawawawawavacadacadacadacadacadacadagagacadacadacadacadacadacadacadacadacad
aaabaaabaaabaaabaaabaaabaaabaaabaaabaeaeaaabaaabaaabaaabaaabaaabaaabaaabaaabaaabaaabaaabaaabaaabaaabaaabaaabaaabaaabaaabaaabaaabaaabaaabaaabaaabaaabaaabaaabaaabaeaeaaabaaabaaabaaabaaabaaabaaabaaabaaab
acadacadacadacadacadacadacadacadacadagagacadacadacadacadacadacadacadacadacadacadacadacadacadacadacadacadacadacadacadacadacadacadacadacadacadacadacadacadacadacadagagacadacadacadacadacadacadacadacadacad
aaabaaabaaabaaabaaabaaabaaabaaabaaabaeaeaaabaaabaaabaaabaaabaaabaaabaaabaaabaaabaaabaaabaaabaaabaaabaaabaaabaaabaaabaaabaaabaaabaaabaaabaaabaaabaaabaaabaaabaaabaeaeaaabaaabaaabaaabaaabaaabaaabaaabaaab
acadacadacadacadacadacadacadacadacadagagacadacadacadacadacadacadacadacadacadacadacadacadacadacadacadacadacadacadacadacadacadacadacadacadacadacadacadacadacadacadagagacadacadacadacadacadacadacadacadacad
aeaeafafafafafafafafafafafafafafafafaVaVafafafafafafafafafafafafafafafafafafafafaaabaaabaaabaaabaaabaaabaaabaaabaaabaaabafafafafafafafafafafafafafafafafafafafafaVaVafafafafafafafafafafafafafafafafaeae
agagafafafafafafafafafafafafafafafafafafafafafafafafafafafafafafafafafafafafafafacadacadacadacadacadacadacadacadacadacadafafafafafafafafafafafafafafafafafafafafafafafafafafafafafafafafafafafafafafagag
aeaeafafafafafafafafafafafafafafafafafafafafafafafafafafafafafafafafafafafafafafafafaaabaaabaaabaaabaaabaaabaaabaaabafafafafafafafafafafafafafafafafafafafafafafafafafafafafafafafafafafafafafafafafaeae
agagafafafafafafafafafafafafafafafafafafafafafafafafafafafafafafafafafafafafafafafafacadacadacadacadacadacadacadacadafafafafafafafafafafafafafafafafafafafafafafafafafafafafafafafafafafafafafafafafagag
aeaeafafafafafafafafafafafafafafafafafafafafafafafafafafafafafafafafafafafafafafafafafafaaabaaabaaabaaabaaabaaabafafafafafafafafafafafafafafafafafafafafafafafafafafafafafafafafafafafafafafafafafafaeae
agagaAaBaCafafafafafafafafafafafafafafafafafafafafafafafafafafafafafafafafafafafafafafafacadacadacadacadacadacadafafafafafafafafafafafafafafafafafafafafafafafafafafafafafafafafafafafafafafafaxayazagag
aeaeaGaHaIafafafafafafafafafafafafafafafafafafafafafafafafafafafafafafafafafafafafafafafaaabaaabaaabaaabaaabaaabafafafafafafafafafafafafafafafafafafafafafafafafafafafafafafafafafafafafafafafaDaEaFaeae
agagaMaNaOafafafafafafafafafafafafafafafafafafafafafafafafafafafafafafafafafafafafafafafacadacadacadacadacadacadafafafafafafafafafafafafafafafafafafafafafafafafafafafafafafafafafafafafafafafaJaKaLagag
aVaVaWaTaXafafafafafafafafafafafafafaYaYafafafafafafafafafafafafafafafafafafafafafafafafaaabaaabaaabaaabaaabaaabafafafafafafafafafafafafafafafafafafafafafafafafaYaYafafafafafafafafafafafafafaZaQbaaVaV
akalamakalamakalamakalamakalamakalamagagafafafafafafafafafafafafafafafakalamakalamakalamacadacadacadacadacadacadakalamakalamakalamafafafafafafafafafafafafafafafagagakalamakalamakalamakalamakalamakalam
anaoapanaoapanaoapanaoapanaoapanaoapaeaeafafafafafafafafafafafaiajaiajanaoapanaoapanaoapaaabaaabaaabaaabaaabaaabanaoapanaoapanaoapaiajaiajafafafafafafafafafafafaeaeanaoapanaoapanaoapanaoapanaoapanaoap
aqarasaqarasaqarasaqarasaqarasaqarasagagaiajaiajafafafafafafafafafafafaqarasaqarasaqarasacadacadacadacadacadacadaqarasaqarasaqarasafafafafafafafafafafafaiajaiajagagaqarasaqarasaqarasaqarasaqarasaqaras
aaabaaabaaabaaabaaabaaabaaabaaabaaabaeaeafafafafafafafafafafafafafafafafafafafafafafafafafafafafafafafafafafafafafafafafafafafafafafafafafafafafafafafafafafafafaeaeaaabaaabaaabaaabaaabaaabaaabaaabaaab
acadacadacadacadacadacadacadacadacadagagafafafafafafafafafafafafafafafafafafafafafafafafafafafafafafafafafafafafafafafafafafafafafafafafafafafafafafafafafafafafagagacadacadacadacadacadacadacadacadacad
aaabaaabaaabaaabaaabaaabaaabaaabaaabaeaeafafafafafafafafafafafafafafafafafafafafafafafafafafafafafafafafafafafafafafafafafafafafafafafafafafafafafafafafafafafafaeaeaaabaaabaaabaaabaaabaaabaaabaaabaaab
acadacadacadacadacadacadacadacadacadagagafafafafafafafafafafafafafafafafafafafafafafafafafafafafafafafafafafafafafafafafafafafafafafafafafafafafafafafafafafafafagagacadacadacadacadacadacadacadacadacad
aaabaaabaaabaaabaaabaaabaaabaaabaaabaeaeafafafafafafafafafafafafafafafafafafafafafafafafafafafafafafafafafafafafafafafafafafafafafafafafafafafafafafafafafafafafaeaeaaabaaabaaabaaabaaabaaabaaabaaabaaab
acadacadacadacadacadacadacadacadacadagagafafafafafafafafafafafafafafafafafafafafafafafafafafafafafafafafafafafafafafafafafafafafafafafafafafafafafafafafafafafafagagacadacadacadacadacadacadacadacadacad
aaabaaabaaabaaabaaabaaabaaabaaabaaabaeaeafafafafafafafafafafafafafafafafafafafafafafafafafafafafafafafafafafafafafafafafafafafafafafafafafafafafafafafafafafafafaeaeaaabaaabaaabaaabaaabaaabaaabaaabaaab
acadacadacadacadacadacadacadacadacadagagafafafafafafafafafafafafafafafafafafafafafafafafafafafafafafafafafafafafafafafafafafafafafafafafafafafafafafafafafafafafagagacadacadacadacadacadacadacadacadacad
aaabaaabaaabaaabaaabaaabaaabaaabaaabaeaeafafafafafafafafafafafafafafafafafafafafafafafafafafafafafafafafafafafafafafafafafafafafafafafafafafafafafafafafafafafafaeaeaaabaaabaaabaaabaaabaaabaaabaaabaaab
acadacadacadacadacadacadacadacadacadagagafafafafafafafafafafafafafafafafafafafafafafafafafafafafafafafafafafafafafafafafafafafafafafafafafafafafafafafafafafafafagagacadacadacadacadacadacadacadacadacad
aaabaaabaaabaaabaaabaaabaaabaaabaaabaeaeafafafafafafafafafafafafafafafafafafafafafafafafafafafafafafafafafafafafafafafafafafafafafafafafafafafafafafafafafafafafaeaeaaabaaabaaabaaabaaabaaabaaabaaabaaab
acadacadacadacadacadacadacadacadacadagagafafafafafafafafafafafafafafafafafafafafafafafafafafafafafafafafafafafafafafafafafafafafafafafafafafafafafafafafafafafafagagacadacadacadacadacadacadacadacadacad
aaabaaabaaabaaabaaabaaabaaabaaabaaabaeaeafafafafafafafafafafafafafafafafafafafafafafafafafafafafafafafafafafafafafafafafafafafafafafafafafafafafafafafafafafafafaeaeaaabaaabaaabaaabaaabaaabaaabaaabaaab
acadacadacadacadacadacadacadacadacadagagafafafafafafafafafafafafafafafafafafafafafafafafafafafafafafafafafafafafafafafafafafafafafafafafafafafafafafafafafafafafagagacadacadacadacadacadacadacadacadacad
aaabaaabaaabaaabaaabaaabaaabaaabaaabaeaeafafafafafafafafafafafafafafafafafafafafafafafafafafafafafafafafafafafafafafafafafafafafafafafafafafafafafafafafafafafafaeaeaaabaaabaaabaaabaaabaaabaaabaaabaaab
acadacadacadacadacadacadacadacadacadagagafafafafafafafafafafafafafafafafafafafafafafafafafafafafafafafafafafafafafafafafafafafafafafafafafafafafafafafafafafafafagagacadacadacadacadacadacadacadacadacad
aaabaaabaaabaaabaaabaaabaaabaaabaaabaVaVafafafafafafafafafafafafafafafafafafafafafafafafafafafafafafafafafafafafafafafafafafafafafafafafafafafafafafafafafafafafaVaVaaabaaabaaabaaabaaabaaabaaabaaabaaab
acadacadacadacadacadacadacadacadacadbbbcbdbbbcbdbbbcbdbbbcbdbbbcbdbbbcbdbbbcbdbbbcbdbbbcbdbbbcbdbbbcbdbbbcbdbbbcbdbbbcbdbbbcbdbbbcbdbbbcbdbbbcbdbbbcbdbbbcbdbbbcbdbbacadacadacadacadacadacadacadacadacad
aaabaaabaaabaaabaaabaaabaaabaaabaaabbebfbgbebfbgbebfbgbebfbgbebfbgbebfbgbebfbgbebfbgbebfbgbebfbgbebfbgbebfbgbebfbgbebfbgbebfbgbebfbgbebfbgbebfbgbebfbgbebfbgbebfbgbeacadacadacadacadacadacadacadacadacad
acadacadacadacadacadacadacadacadacadbhbibjbhbibjbhbibjbhbibjbhbibjbhbibjbhbibjbhbibjbhbibjbhbibjbhbibjbhbibjbhbibjbhbibjbhbibjbhbibjbhbibjbhbibjbhbibjbhbibjbhbibjbhaaabaaabaaabaaabaaabaaabaaabaaabaaab
aaabaaabaaabaaabaaabaaabaaabaaabaaabbhbibjbhbibjbhbibjbhbibjbhbibjbhbibjbhbibjbhbibjbhbibjbhbibjbhbibjbhbibjbhbibjbhbibjbhbibjbhbibjbhbibjbhbibjbhbibjbhbibjbhbibjbhacadacadacadacadacadacadacadacadacad
acadacadacadacadacadacadacadacadacadbhbibjbhbibjbhbibjbhbibjbhbibjbhbibjbhbibjbhbibjbhbibjbhbibjbhbibjbhbibjbhbibjbhbibjbhbibjbhbibjbhbibjbhbibjbhbibjbhbibjbhbibjbhaaabaaabaaabaaabaaabaaabaaabaaabaaab
aaabaaabaaabaaabaaabaaabaaabaaabaaabbhbibjbhbibjbhbibjbhbibjbhbibjbhbibjbhbibjbhbibjbhbibjbhbibjbhbibjbhbibjbhbibjbhbibjbhbibjbhbibjbhbibjbhbibjbhbibjbhbibjbhbibjbhacadacadacadacadacadacadacadacadacad
acadacadacadacadacadacadacadacadacadbhbibjbhbibjbhbibjbhbibjbhbibjbhbibjbhbibjbhbibjbhbibjbhbibjbhbibjbhbibjbhbibjbhbibjbhbibjbhbibjbhbibjbhbibjbhbibjbhbibjbhbibjbhbibjbhbibjbhbibjbhbibjbhbibjbhbibjbh
"}
